release_date,movie,production_budget,domestic_gross,domestic_profit,domestic_ROI,Year
5/20/2011,Pirates of the Caribbean: On Stranger Tides,410600000,241063875,-169536125,-41.28985022,2011
6/7/2019,Dark Phoenix,350000000,42762350,-307237650,-87.78218571,2019
5/1/2015,Avengers: Age of Ultron,330600000,459005868,128405868,38.84025045,2015
12/15/2017,Star Wars Ep. VIII: The Last Jedi,317000000,620181382,303181382,95.64081451,2017
12/18/2015,Star Wars Ep. VII: The Force Awakens,306000000,936662225,630662225,206.0987663,2015
4/27/2018,Avengers: Infinity War,300000000,678815482,378815482,126.2718273,2018
11/17/2017,Justice League,300000000,229024295,-70975705,-23.65856833,2017
11/6/2015,Spectre,300000000,200074175,-99925825,-33.30860833,2015
3/9/2012,John Carter,275000000,73058679,-201941321,-73.43320764,2012
5/25/2018,Solo: A Star Wars Story,275000000,213767512,-61232488,-22.26635927,2018
7/20/2012,The Dark Knight Rises,275000000,448139099,173139099,62.95967236,2012
7/2/2013,The Lone Ranger,275000000,89302115,-185697885,-67.52650364,2013
11/24/2010,Tangled,260000000,200821936,-59178064,-22.76079385,2010
3/25/2016,Batman v Superman: Dawn of Justice,250000000,330360194,80360194,32.1440776,2016
5/6/2016,Captain America: Civil War,250000000,408084349,158084349,63.2337396,2016
4/14/2017,The Fate of the Furious,250000000,225764765,-24235235,-9.694094,2017
12/14/2012,The Hobbit: An Unexpected Journey,250000000,303003568,53003568,21.2014272,2012
12/17/2014,The Hobbit: The Battle of the Five Armies,250000000,255119788,5119788,2.0479152,2014
12/13/2013,The Hobbit: The Desolation of Smaug,250000000,258366855,8366855,3.346742,2013
5/26/2017,Pirates of the Caribbean: Dead Men Tell No Tales,230000000,172558876,-57441124,-24.97440174,2017
6/14/2013,Man of Steel,225000000,291045518,66045518,29.35356356,2013
5/4/2012,The Avengers,225000000,623279547,398279547,177.013132,2012
5/18/2012,Battleship,220000000,65233400,-154766600,-70.34845455,2012
7/3/2012,The Amazing Spider-Man,220000000,262030663,42030663,19.10484682,2012
6/21/2017,Transformers: The Last Knight,217000000,130168683,-86831317,-40.0144318,2017
6/12/2015,Jurassic World,215000000,652270625,437270625,203.381686,2015
5/25/2012,Men in Black 3,215000000,179020854,-35979146,-16.73448651,2012
5/14/2010,Robin Hood,210000000,105487148,-104512852,-49.76802476,2010
6/27/2014,Transformers: Age of Extinction,210000000,245439076,35439076,16.87575048,2014
3/5/2010,Alice in Wonderland,200000000,334191110,134191110,67.095555,2010
2/16/2018,Black Panther,200000000,700059566,500059566,250.029783,2018
6/24/2011,Cars 2,200000000,191450875,-8549125,-4.2745625,2011
11/16/2018,Fantastic Beasts: The Crimes of Grindelwald,200000000,159555901,-40444099,-20.2220495,2018
6/17/2016,Finding Dory,200000000,486295561,286295561,143.1477805,2016
6/17/2011,Green Lantern,200000000,116601172,-83398828,-41.699414,2011
5/5/2017,Guardians of the Galaxy Vol 2,200000000,389813101,189813101,94.9065505,2017
6/15/2018,Incredibles 2,200000000,608581744,408581744,204.290872,2018
5/3/2013,Iron Man 3,200000000,408992272,208992272,104.496136,2013
6/21/2013,Monsters University,200000000,268488329,68488329,34.2441645,2013
3/8/2013,Oz the Great and Powerful,200000000,234770996,34770996,17.385498,2013
5/28/2010,Prince of Persia: Sands of Time,200000000,90759676,-109240324,-54.620162,2010
12/16/2016,Rogue One: A Star Wars Story,200000000,532177324,332177324,166.088662,2016
11/8/2012,Skyfall,200000000,304360277,104360277,52.1801385,2012
5/2/2014,The Amazing Spider-Man 2,200000000,202853933,2853933,1.4269665,2014
6/18/2010,Toy Story 3,200000000,415004880,215004880,107.50244,2010
12/17/2010,Tron: Legacy,200000000,172062763,-27937237,-13.9686185,2010
5/23/2014,X-Men: Days of Future Past,200000000,233921534,33921534,16.960767,2014
3/1/2013,Jack the Giant Slayer,195000000,65187603,-129812397,-66.57046,2013
6/9/2017,The Mummy,195000000,80101125,-114898875,-58.9225,2017
6/29/2011,Transformers: Dark of the Moon,195000000,352390543,157390543,80.71309897,2011
4/3/2015,Furious 7,190000000,353007020,163007020,85.79316842,2015
7/12/2013,Pacific Rim,190000000,101802906,-88197094,-46.41952316,2013
5/16/2013,Star Trek Into Darkness,190000000,228778661,38778661,20.40982158,2013
5/10/2013,The Great Gatsby,190000000,144840419,-45159581,-23.76820053,2013
6/21/2013,World War Z,190000000,202359711,12359711,6.505111053,2013
11/25/2015,The Good Dinosaur,187500000,123087120,-64412880,-34.353536,2015
10/6/2017,Blade Runner 2049,185000000,92054159,-92945841,-50.24099514,2017
6/22/2012,Brave,185000000,237282182,52282182,28.26063892,2012
3/10/2017,Kong: Skull Island,185000000,168052812,-16947188,-9.160642162,2017
7/22/2016,Star Trek Beyond,185000000,158848340,-26151660,-14.13603243,2016
5/24/2019,Aladdin,182000000,246734314,64734314,35.5683044,2019
11/18/2016,Fantastic Beasts and Where to Find Them,180000000,234037575,54037575,30.020875,2016
11/23/2011,Hugo,180000000,73864507,-106135493,-58.96416278,2011
5/30/2014,Maleficent,180000000,241407328,61407328,34.11518222,2014
7/1/2016,The Legend of Tarzan,180000000,126643061,-53356939,-29.64274389,2016
11/3/2017,Thor: Ragnarok,180000000,315058289,135058289,75.03238278,2017
7/21/2017,Valerian and the City of a Thousand Planets,180000000,40479370,-139520630,-77.51146111,2017
2/6/2015,Jupiter Ascending,179000000,47482519,-131517481,-73.47345307,2015
6/6/2014,Edge of Tomorrow,178000000,100206256,-77793744,-43.70435056,2014
7/27/2018,Mission: ImpossibleâFallout,178000000,220159104,42159104,23.68488989,2018
8/10/2018,The Meg,178000000,145443742,-32556258,-18.29003258,2018
5/27/2016,X-Men: Apocalypse,178000000,155442489,-22557511,-12.67275899,2016
12/25/2013,47 Ronin,175000000,38362475,-136637525,-78.07858571,2013
3/8/2019,Captain Marvel,175000000,426525952,251525952,143.7291154,2019
6/16/2017,Cars 3,175000000,152901115,-22098885,-12.62793429,2017
11/22/2017,Coco,175000000,209726015,34726015,19.84343714,2017
6/19/2015,Inside Out,175000000,356461711,181461711,103.6924063,2015
5/12/2017,King Arthur: Legend of the Sword,175000000,39175066,-135824934,-77.614248,2017
11/21/2018,Ralph Breaks The Internet,175000000,201091711,26091711,14.90954914,2018
7/7/2017,Spider-Man: Homecoming,175000000,334201140,159201140,90.97208,2017
8/5/2016,Suicide Squad,175000000,325100054,150100054,85.77145943,2016
4/15/2016,The Jungle Book,175000000,364001123,189001123,108.0006417,2016
5/27/2016,Alice Through the Looking Glass,170000000,77042381,-92957619,-54.68095235,2016
2/14/2019,Alita: Battle Angel,170000000,85710210,-84289790,-49.58222941,2019
4/4/2014,Captain America: The Winter Soldier,170000000,259746958,89746958,52.79232824,2014
7/11/2014,Dawn of the Planet of the Apes,170000000,208545589,38545589,22.67387588,2014
3/29/2019,Dumbo,170000000,113883318,-56116682,-33.00981294,2019
5/31/2019,Godzilla: King of the Monsters,170000000,85576941,-84423059,-49.66062294,2019
8/1/2014,Guardians of the Galaxy,170000000,333172112,163172112,95.98359529,2014
5/7/2010,Iron Man 2,170000000,312433331,142433331,83.78431235,2010
6/22/2018,Jurassic World: Fallen Kingdom,170000000,417719760,247719760,145.7175059,2018
6/1/2012,Snow White and the Huntsman,170000000,155136755,-14863245,-8.743085294,2012
5/22/2015,Tomorrowland,170000000,93436322,-76563678,-45.03745765,2015
11/7/2014,Big Hero 6,165000000,222527828,57527828,34.8653503,2014
11/4/2016,Doctor Strange,165000000,232641920,67641920,40.99510303,2016
3/26/2010,How to Train Your Dragon,165000000,217581232,52581232,31.86741333,2010
6/24/2016,Independence Day: Resurgence,165000000,103144286,-61855714,-37.48831152,2016
11/5/2014,Interstellar,165000000,188017894,23017894,13.95023879,2014
5/21/2010,Shrek Forever After,165000000,238736787,73736787,44.68896182,2010
11/2/2012,Wreck-It Ralph,165000000,189412677,24412677,14.79556182,2012
7/29/2011,Cowboys and Aliens,163000000,100368560,-62631440,-38.42419632,2011
12/21/2018,Aquaman,160000000,335061807,175061807,109.4136294,2018
3/17/2017,Beauty and the Beast,160000000,504014165,344014165,215.0088531,2017
5/24/2013,Fast and Furious 6,160000000,238679850,78679850,49.17490625,2013
5/16/2014,Godzilla,160000000,200676069,40676069,25.42254313,2014
7/16/2010,Inception,160000000,292576195,132576195,82.86012188,2010
11/20/2015,The Hunger Games: Mockingjay - Part 2,160000000,281723902,121723902,76.07743875,2015
7/14/2010,The Sorcerer's Apprentice,160000000,63150991,-96849009,-60.53063063,2010
6/10/2016,Warcraft,160000000,47225655,-112774345,-70.48396563,2016
6/3/2011,X-Men: First Class,160000000,146408305,-13591695,-8.494809375,2011
9/30/2016,Deepwater Horizon,156000000,61433527,-94566473,-60.61953397,2016
3/23/2018,Pacific Rim: Uprising,155000000,59874525,-95125475,-61.37127419,2018
7/1/2015,Terminator: Genisys,155000000,89760956,-65239044,-42.08970581,2015
12/10/2010,The Chronicles of Narnia: The Voyage of the Dawn Treader,155000000,104386950,-50613050,-32.65358065,2010
7/14/2017,War for the Planet of the Apes,152000000,146880162,-5119838,-3.368314474,2017
5/11/2012,Dark Shadows,150000000,79727149,-70272851,-46.84856733,2012
7/21/2017,Dunkirk,150000000,190068280,40068280,26.71218667,2017
11/22/2013,Frozen,150000000,400738009,250738009,167.1586727,2013
5/26/2011,Kung Fu Panda 2,150000000,165249063,15249063,10.166042,2011
5/15/2015,Mad Max: Fury Road,150000000,153636354,3636354,2.424236,2015
3/11/2011,Mars Needs Moms,150000000,21392758,-128607242,-85.73816133,2011
7/31/2015,Mission: ImpossibleâRogue Nation,150000000,195042377,45042377,30.02825133,2015
11/23/2016,Moana,150000000,248757044,98757044,65.83802933,2016
10/9/2015,Pan,150000000,35088320,-114911680,-76.60778667,2015
5/10/2019,PokÃ©mon: Detective Pikachu,150000000,139507806,-10492194,-6.994796,2019
3/29/2018,Ready Player One,150000000,137690172,-12309828,-8.206552,2018
2/17/2017,The Great Wall,150000000,45157105,-104842895,-69.89526333,2017
7/1/2010,The Last Airbender,150000000,131772187,-18227813,-12.15187533,2010
2/12/2010,The Wolfman,150000000,62189884,-87810116,-58.54007733,2010
5/6/2011,Thor,150000000,181030624,31030624,20.68708267,2011
11/8/2013,Thor: The Dark World,150000000,206362140,56362140,37.57476,2013
6/28/2013,White House Down,150000000,73103784,-76896216,-51.264144,2013
6/2/2017,Wonder Woman,150000000,412563408,262563408,175.042272,2017
3/30/2012,Wrath of the Titans,150000000,83670083,-66329917,-44.21994467,2012
3/4/2016,Zootopia,150000000,341268248,191268248,127.5121653,2016
6/13/2014,How to Train Your Dragon 2,145000000,177002924,32002924,22.07098207,2014
6/8/2012,Madagascar 3: Europe's Most Wanted,145000000,216391482,71391482,49.23550483,2012
12/16/2011,Mission: ImpossibleâGhost Protocol,145000000,209397903,64397903,44.4123469,2011
3/7/2014,Mr. Peabody & Sherman,145000000,111506430,-33493570,-23.09901379,2014
11/21/2012,Rise of the Guardians,145000000,103412758,-41587242,-28.68085655,2012
7/15/2016,Ghostbusters,144000000,128350574,-15649426,-10.86765694,2016
7/22/2011,Captain America: The First Avenger,140000000,176654505,36654505,26.18178929,2011
12/12/2014,Exodus: Gods and Kings,140000000,65014513,-74985487,-53.56106214,2014
3/27/2013,G.I. Joe: Retaliation,140000000,122523060,-17476940,-12.48352857,2013
2/26/2016,Gods of Egypt,140000000,31153464,-108846536,-77.74752571,2016
1/29/2016,Kung Fu Panda 3,140000000,143528619,3528619,2.520442143,2016
7/1/2016,The BFG,140000000,55483770,-84516230,-60.36873571,2016
11/16/2012,"The Twilight Saga: Breaking Dawn, Part 2",136200000,292324737,156124737,114.6290286,2012
11/18/2011,Happy Feet Two,135000000,64006466,-70993534,-52.58780296,2011
3/4/2011,Rango,135000000,123477607,-11522393,-8.535105926,2011
6/3/2016,Teenage Mutant Ninja Turtles: Out of the Shadows,135000000,82051601,-52948399,-39.2210363,2016
3/22/2013,The Croods,135000000,187168425,52168425,38.64327778,2013
12/25/2015,The Revenant,135000000,183637894,48637894,36.02806963,2015
7/17/2013,Turbo,135000000,83028130,-51971870,-38.49768148,2013
11/2/2018,The Nutcracker and the Four Realms,132900000,54858851,-78041149,-58.7217073,2018
11/26/2014,Penguins of Madagascar,132000000,83350911,-48649089,-36.85537045,2014
5/31/2013,After Earth,130000000,60522097,-69477903,-53.44454077,2013
7/17/2015,Ant-Man,130000000,180202163,50202163,38.61704846,2015
7/6/2018,Ant-Man and the Wasp,130000000,216648740,86648740,66.65287692,2018
3/27/2015,Home,130000000,177397510,47397510,36.45962308,2015
12/19/2018,Mary Poppins Returns,130000000,171958438,41958438,32.27572154,2018
11/5/2010,Megamind,130000000,148415853,18415853,14.16604077,2010
3/28/2014,Noah,130000000,101200044,-28799956,-22.15381231,2014
10/28/2011,Puss in Boots,130000000,149260504,19260504,14.81577231,2011
7/19/2013,R.I.P.D.,130000000,33618855,-96381145,-74.13934231,2013
4/11/2014,Rio 2,130000000,131538435,1538435,1.183411538,2014
7/23/2010,Salt,130000000,118311368,-11688632,-8.991255385,2010
12/21/2011,The Adventures of Tintin,130000000,77591831,-52408169,-40.31397615,2011
11/22/2013,The Hunger Games: Catching Fire,130000000,424668047,294668047,226.6677285,2013
2/22/2019,How to Train Your Dragon: The Hidden World,129000000,160791800,31791800,24.6448062,2019
11/18/2011,"The Twilight Saga: Breaking Dawn, Part 1",127500000,281287133,153787133,120.6173592,2011
3/3/2017,Logan,127000000,226277068,99277068,78.17091969,2017
12/19/2014,Night at the Museum: Secret of the Tomb,127000000,113746621,-13253379,-10.4357315,2014
12/21/2016,Assassinâs Creed,125000000,54647948,-70352052,-56.2816416,2016
4/1/2010,Clash of the Titans,125000000,163214888,38214888,30.5719104,2010
4/29/2011,Fast Five,125000000,210031325,85031325,68.02506,2011
11/19/2010,Harry Potter and the Deathly Hallows: Part I,125000000,296131568,171131568,136.9052544,2010
7/15/2011,Harry Potter and the Deathly Hallows: Part II,125000000,381193157,256193157,204.9545256,2011
1/13/2017,Monster Trucks,125000000,33370166,-91629834,-73.3038672,2017
6/8/2012,Prometheus,125000000,126477084,1477084,1.1816672,2012
12/16/2011,Sherlock Holmes: A Game of Shadows,125000000,186848418,61848418,49.4787344,2011
7/13/2018,Skyscraper,125000000,68420120,-56579880,-45.263904,2018
8/8/2014,Teenage Mutant Ninja Turtles,125000000,191204754,66204754,52.9638032,2014
3/31/2017,The Boss Baby,125000000,175003033,50003033,40.0024264,2017
8/10/2012,The Bourne Legacy,125000000,113203870,-11796130,-9.436904,2012
11/21/2014,The Hunger Games: Mockingjay - Part 1,125000000,337135885,212135885,169.708708,2014
8/3/2012,Total Recall,125000000,58877969,-66122031,-52.8976248,2012
11/4/2016,Trolls,125000000,153707064,28707064,22.9656512,2016
8/9/2013,Elysium,120000000,93050117,-26949883,-22.45823583,2013
8/7/2015,Fantastic Four,120000000,56117548,-63882452,-53.23537667,2015
12/17/2010,How Do You Know?,120000000,30212620,-89787380,-74.82281667,2010
7/29/2016,Jason Bourne,120000000,162192920,42192920,35.16076667,2016
11/21/2012,Life of Pi,120000000,124987022,4987022,4.155851667,2012
4/19/2013,Oblivion,120000000,89107235,-30892765,-25.74397083,2013
3/24/2017,Power Rangers,120000000,85364450,-34635550,-28.86295833,2017
4/13/2018,Rampage,120000000,101028233,-18971767,-15.80980583,2018
2/12/2014,RoboCop,120000000,58607007,-61392993,-51.1608275,2014
6/23/2010,Knight and Day,117000000,76423035,-40576965,-34.68116667,2010
10/5/2018,Venom,116000000,213511408,97511408,84.06155862,2018
4/22/2016,The Huntsman: Winterâs War,115000000,48003015,-66996985,-58.25824783,2016
7/26/2013,The Wolverine,115000000,132556852,17556852,15.26682783,2013
12/25/2010,Gulliver's Travels,112000000,42779261,-69220739,-61.80423125,2010
12/15/2017,Ferdinand,111000000,84410380,-26589620,-23.95461261,2017
3/7/2014,300: Rise of an Empire,110000000,106580051,-3419949,-3.109044545,2014
5/18/2018,Deadpool 2,110000000,324591735,214591735,195.0833955,2018
11/1/2013,Ender's Game,110000000,61737191,-48262809,-43.87528091,2013
3/31/2017,Ghost in the Shell,110000000,40563557,-69436443,-63.12403909,2017
10/4/2013,Gravity,110000000,274092705,164092705,149.1751864,2013
6/14/2019,Men in Black: International,110000000,3100000,-106900000,-97.18181818,2019
9/30/2016,Miss Peregrineâs Home for Peculiar Children,110000000,87242834,-22757166,-20.68833273,2016
12/21/2016,Passengers,110000000,100014699,-9985301,-9.077546364,2016
10/7/2011,Real Steel,110000000,85463309,-24536691,-22.30608273,2011
5/29/2015,San Andreas,110000000,155190832,45190832,41.08257455,2015
6/11/2010,The A-Team,110000000,77222099,-32777901,-29.79809182,2010
3/18/2016,The Divergent Series: Allegiant,110000000,66184051,-43815949,-39.83268091,2016
3/20/2015,The Divergent Series: Insurgent,110000000,130179072,20179072,18.34461091,2015
1/14/2011,The Green Hornet,110000000,98780042,-11219958,-10.19996182,2011
7/29/2011,The Smurfs,110000000,142614158,32614158,29.64923455,2011
7/31/2013,The Smurfs 2,110000000,71017784,-38982216,-35.43837818,2013
10/2/2015,The Martian,108000000,228433663,120433663,111.5126509,2015
11/23/2016,Allied,106000000,40098064,-65901936,-62.17163774,2016
7/22/2016,Ice Age: Collision Course,105000000,64063008,-40936992,-38.98761143,2016
9/22/2017,Kingsman: The Golden Circle,104000000,100234838,-3765162,-3.620348077,2017
3/9/2018,A Wrinkle in Time,103000000,100478608,-2521392,-2.447953398,2018
5/23/2013,The Hangover 3,103000000,112200072,9200072,8.932108738,2013
12/21/2018,Bumblebee,102000000,127195589,25195589,24.70155784,2018
10/26/2012,Cloud Atlas,102000000,27108272,-74891728,-73.42326275,2012
12/25/2012,Django Unchained,100000000,162805434,62805434,62.805434,2012
5/24/2013,Epic,100000000,107518682,7518682,7.518682,2013
10/20/2017,Geostorm,100000000,33700160,-66299840,-66.29984,2017
3/12/2010,Green Zone,100000000,35497337,-64502663,-64.502663,2010
7/25/2014,Hercules,100000000,72688614,-27311386,-27.311386,2014
12/11/2015,In the Heart of the Sea,100000000,25020758,-74979242,-74.979242,2015
1/20/2012,Jin lÃ­ng shÃ­ san chai,100000000,311434,-99688566,-99.688566,2012
9/24/2010,Legend of the Guardians: The Owls of Ga'Hoole,100000000,55675313,-44324687,-44.324687,2010
12/22/2010,Little Fockers,100000000,148438600,48438600,48.4386,2010
12/14/2018,Mortal Engines,100000000,15951040,-84048960,-84.04896,2018
12/25/2015,Point Break,100000000,28782481,-71217519,-71.217519,2015
8/17/2012,The Expendables 2,100000000,85028192,-14971808,-14.971808,2012
8/15/2014,The Expendables 3,100000000,39322544,-60677456,-60.677456,2014
8/6/2010,The Other Guys,100000000,119219978,19219978,19.219978,2010
12/10/2010,The Tourist,100000000,67631157,-32368843,-32.368843,2010
12/25/2013,The Wolf of Wall Street,100000000,116900694,16900694,16.900694,2013
4/18/2014,Transcendence,100000000,23022309,-76977691,-76.977691,2014
3/15/2019,Wonder Park,100000000,45216793,-54783207,-54.783207,2019
11/21/2018,Robin Hood,99000000,30824628,-68175372,-68.86401212,2018
2/8/2019,The LEGO Movie 2: The Second Part,99000000,105806508,6806508,6.875260606,2019
11/6/2015,The Peanuts Movie,99000000,130178411,31178411,31.49334444,2015
5/19/2017,Alien: Covenant,97000000,74262031,-22737969,-23.44120515,2017
8/19/2016,Ben-Hur,95000000,26410477,-68589523,-72.19949789,2016
3/13/2015,Cinderella,95000000,201151353,106151353,111.7382663,2015
7/13/2012,Ice Age: Continental Drift,95000000,161321843,66321843,69.81246632,2012
2/12/2010,Percy Jackson & the Olympians: The Lightning Thief,95000000,88768303,-6231697,-6.559681053,2010
2/6/2015,Seventh Son,95000000,17725785,-77274215,-81.34127895,2015
5/27/2010,Sex and the City 2,95000000,95347692,347692,0.365991579,2010
8/10/2012,The Campaign,95000000,86907746,-8092254,-8.518162105,2012
11/12/2010,Unstoppable,95000000,81562942,-13437058,-14.14427158,2010
2/13/2015,Kingsman: The Secret Service,94000000,128261724,34261724,36.44864255,2015
8/5/2011,Rise of the Planet of the Apes,93000000,176760185,83760185,90.06471505,2011
2/14/2013,A Good Day to Die Hard,92000000,67349198,-24650802,-26.79435,2013
12/25/2013,The Secret Life of Walter Mitty,91000000,58236838,-32763162,-36.00347473,2013
12/18/2015,Alvin and the Chipmunks: The Road Chip,90000000,85886987,-4113013,-4.570014444,2015
12/31/2019,Army of the Dead,90000000,0,-90000000,-100,2019
12/13/2017,Bright,90000000,0,-90000000,-100,2017
8/19/2011,Conan the Barbarian,90000000,21295021,-68704979,-76.33886556,2011
12/20/2017,Jumanji: Welcome to the Jungle,90000000,404508916,314508916,349.4543511,2017
6/10/2016,Now You See Me 2,90000000,65075540,-24924460,-27.69384444,2016
8/7/2013,Percy Jackson: Sea of Monsters,90000000,68559554,-21440446,-23.82271778,2013
7/24/2015,Pixels,90000000,78765986,-11234014,-12.48223778,2015
4/15/2011,Rio,90000000,143619809,53619809,59.57756556,2011
12/14/2018,Spider-Man: Into The Spider-Verse 3D,90000000,190173195,100173195,111.30355,2018
12/20/2011,The Girl with the Dragon Tattoo,90000000,102515793,12515793,13.90643667,2011
9/23/2016,The Magnificent Seven,90000000,93432655,3432655,3.814061111,2016
11/24/2010,The Nutcracker in 3D,90000000,195459,-89804541,-99.78282333,2010
4/21/2017,The Promise,90000000,8224288,-81775712,-90.86190222,2017
10/21/2011,The Three Musketeers,90000000,20377913,-69622087,-77.35787444,2011
3/16/2018,Tomb Raider,90000000,58250803,-31749197,-35.27688556,2018
9/14/2018,The Predator,88000000,51024708,-36975292,-42.01737727,2018
11/23/2011,Arthur Christmas,85000000,46462469,-38537531,-45.33827176,2011
7/30/2010,Cats & Dogs: The Revenge of Kitty Galore,85000000,43585753,-41414247,-48.72264353,2010
3/21/2014,Divergent,85000000,150947895,65947895,77.58575882,2014
9/28/2012,Hotel Transylvania,85000000,148313048,63313048,74.48593882,2012
3/30/2012,Mirror Mirror,85000000,64935167,-20064833,-23.60568588,2012
2/10/2012,Safe House,85000000,126181630,41181630,48.44897647,2012
8/13/2010,Scott Pilgrim vs. The World,85000000,31611316,-53388684,-62.81021647,2010
4/5/2019,Shazam!,85000000,139606856,54606856,64.24336,2019
11/4/2011,Tower Heist,85000000,78046570,-6953430,-8.180505882,2011
1/20/2017,xXx: Return of Xander Cage,85000000,44898413,-40101587,-47.17833765,2017
7/19/2013,RED 2,84000000,53262560,-30737440,-36.59219048,2013
12/20/2017,The Greatest Showman,84000000,174340174,90340174,107.5478262,2017
8/13/2010,The Expendables,82000000,103068524,21068524,25.69332195,2010
12/16/2011,Alvin and the Chipmunks: Chipwrecked,80000000,133107389,53107389,66.38423625,2011
10/17/2014,Fury,80000000,85817906,5817906,7.2723825,2014
7/12/2013,Grown Ups 2,80000000,133668525,53668525,67.08565625,2013
9/25/2015,Hotel Transylvania 2,80000000,169700110,89700110,112.1251375,2015
2/11/2011,Just Go With It,80000000,103028109,23028109,28.78513625,2011
4/22/2010,Oceans,80000000,19422319,-60577681,-75.72210125,2010
2/21/2014,Pompeii,80000000,23169033,-56830967,-71.03870875,2014
2/19/2010,Shutter Island,80000000,128012934,48012934,60.0161675,2010
9/28/2018,Smallfoot,80000000,83240103,3240103,4.05012875,2018
1/15/2010,The Book of Eli,80000000,94835059,14835059,18.54382375,2010
5/26/2011,The Hangover Part II,80000000,254464305,174464305,218.0803813,2011
3/23/2012,The Hunger Games,80000000,408010692,328010692,410.013365,2012
10/23/2015,The Last Witch Hunter,80000000,27367660,-52632340,-65.790425,2015
2/10/2017,The Lego Batman Movie,80000000,175750384,95750384,119.68798,2017
6/7/2019,The Secret Life of Pets 2,80000000,63795655,-16204345,-20.25543125,2019
12/20/2013,Walking with Dinosaurs,80000000,36076121,-43923879,-54.90484875,2013
12/17/2010,Yogi Bear,80000000,100246011,20246011,25.30751375,2010
7/8/2011,Zookeeper,80000000,80360866,360866,0.4510825,2011
11/11/2011,Jack and Jill,79000000,74158157,-4841843,-6.12891519,2011
2/10/2012,Journey 2: The Mysterious Island,79000000,103860290,24860290,31.46872152,2012
9/27/2013,Cloudy with a Chance of Meatballs 2,78000000,119793567,41793567,53.58149615,2013
12/31/2012,AstÃ©rix et ObÃ©lix: Au service de Sa MajestÃ©,77600000,0,-77600000,-100,2012
1/22/2019,Renegades,77500000,0,-77500000,-100,2019
2/12/2016,The Little Prince,77500000,1311213,-76188787,-98.30811226,2016
7/20/2018,The Equalizer 2,77000000,102084362,25084362,32.57709351,2018
7/3/2013,Despicable Me 2,76000000,368065385,292065385,384.2965592,2013
12/31/2019,355,75000000,0,-75000000,-100,2019
8/3/2018,Christopher Robin,75000000,99215042,24215042,32.28672267,2018
6/30/2017,Despicable Me 3,75000000,264624300,189624300,252.8324,2017
11/9/2018,Dr. Seussâ The Grinch,75000000,270620950,195620950,260.8279333,2018
6/25/2010,Grown Ups,75000000,162001186,87001186,116.0015813,2010
11/11/2011,Immortals,75000000,83504017,8504017,11.33868933,2011
10/28/2016,Inferno,75000000,34343574,-40656426,-54.208568,2016
6/4/2010,Killers,75000000,47059963,-27940037,-37.25338267,2010
5/31/2013,Now You See Me,75000000,117723989,42723989,56.96531867,2013
8/30/2019,PLAYMOBIL,75000000,0,-75000000,-100,2019
12/21/2016,Sing,75000000,270329045,195329045,260.4387267,2016
3/25/2011,Sucker Punch,75000000,36392502,-38607498,-51.476664,2011
8/14/2015,The Man From U.N.C.L.E.,75000000,45445109,-29554891,-39.40652133,2015
7/8/2016,The Secret Life of Pets,75000000,368384330,293384330,391.1791067,2016
7/10/2015,Minions,74000000,336045770,262045770,354.1159054,2015
2/6/2015,The SpongeBob Movie: Sponge Out of Water,74000000,162994032,88994032,120.2622054,2015
5/20/2016,The Angry Birds Movie,73000000,107509366,34509366,47.27310411,2016
5/28/2010,Agora,70000000,619423,-69380577,-99.11511,2010
3/11/2011,Battle: Los Angeles,70000000,83552429,13552429,19.36061286,2011
1/16/2015,Blackhat,70000000,8005980,-61994020,-88.56288571,2015
11/10/2017,Daddyâs Home 2,70000000,104029443,34029443,48.61349,2017
10/10/2014,Dracula Untold,70000000,55991880,-14008120,-20.0116,2014
10/18/2013,Escape Plan,70000000,25135965,-44864035,-64.09147857,2013
9/23/2011,Killer Elite,70000000,25124986,-44875014,-64.10716286,2011
5/9/2014,Legends of Oz: Dorothyâs Return,70000000,8462347,-61537653,-87.91093286,2014
6/8/2018,Oceanâs 8,70000000,140218711,70218711,100.3124443,2018
3/22/2013,Olympus Has Fallen,70000000,98927592,28927592,41.32513143,2013
6/15/2012,Rock of Ages,70000000,38518613,-31481387,-44.97341,2012
9/23/2016,Storks,70000000,72679278,2679278,3.82754,2016
1/14/2011,The Dilemma,70000000,48475290,-21524710,-30.74958571,2011
1/29/2016,The Finest Hours,70000000,27569558,-42430442,-60.61491714,2016
1/10/2014,The Legend of Hercules,70000000,18848538,-51151462,-73.07351714,2014
9/22/2017,The Lego Ninjago Movie,70000000,59281555,-10718445,-15.31206429,2017
2/7/2014,The Monuments Men,70000000,78031620,8031620,11.47374286,2014
1/20/2012,Underworld: Awakening,70000000,62321039,-7678961,-10.96994429,2012
9/24/2010,Wall Street 2: Money Never Sleeps,70000000,52474616,-17525384,-25.03626286,2010
12/25/2011,War Horse,70000000,79883359,9883359,14.11908429,2011
7/9/2010,Despicable Me,69000000,251513985,182513985,264.5130217,2010
7/30/2010,Dinner for Schmucks,69000000,73026337,4026337,5.835271014,2010
3/2/2018,Red Sparrow,69000000,46874505,-22125495,-32.06593478,2018
12/22/2017,Downsizing,68000000,24449754,-43550246,-64.04447941,2017
2/25/2011,Hall Pass,68000000,45060734,-22939266,-33.73421471,2011
6/26/2015,Ted 2,68000000,81476385,13476385,19.81821324,2015
6/30/2010,The Twilight Saga: Eclipse,68000000,300531751,232531751,341.9584574,2010
6/22/2012,Abraham Lincoln: Vampire Hunter,67500000,37519139,-29980861,-44.41609037,2012
3/2/2012,Doctor Seuss' The Lorax,67500000,214030500,146530500,217.0822222,2012
3/14/2014,Need for Speed,66000000,43568507,-22431493,-33.98711061,2014
10/26/2018,Air Strike,65000000,0,-65000000,-100,2018
12/19/2014,Annie,65000000,85911262,20911262,32.17117231,2014
11/5/2010,Due Date,65000000,100539043,35539043,54.67545077,2010
9/18/2015,Everest,65000000,43482270,-21517730,-33.1042,2015
2/27/2015,Focus,65000000,53862963,-11137037,-17.13390308,2015
7/13/2018,Hotel Transylvania 3: Summer Vacation,65000000,167500092,102500092,157.6924492,2018
1/24/2014,"I, Frankenstein",65000000,19075290,-45924710,-70.6534,2014
12/25/2012,Les Miserables,65000000,148809770,83809770,128.9381077,2012
11/9/2012,Lincoln,65000000,182207973,117207973,180.3199585,2012
12/25/2016,Live by Night,65000000,10378555,-54621445,-84.03299231,2016
8/12/2016,Peteâs Dragon,65000000,76233151,11233151,17.28177077,2016
11/21/2012,Red Dawn,65000000,44806783,-20193217,-31.06648769,2012
9/14/2012,Resident Evil: Retribution,65000000,42345531,-22654469,-34.85302923,2012
8/22/2014,Sin City: A Dame to Kill For,65000000,13757804,-51242196,-78.83414769,2014
6/5/2015,Spy!,65000000,110825712,45825712,70.50109538,2015
5/16/2012,The Dictator,65000000,59650222,-5349778,-8.230427692,2012
2/17/2012,This Means War,65000000,54760791,-10239209,-15.75262923,2012
9/4/2015,Tian jiang xiong shi,65000000,74070,-64925930,-99.88604615,2015
12/25/2014,Unbroken,65000000,115637895,50637895,77.90445385,2014
9/15/2017,American Assassin,63000000,36249674,-26750326,-42.46083492,2017
4/1/2011,Hop,63000000,108085305,45085305,71.56397619,2011
12/25/2015,The Hateful Eight,62000000,54117416,-7882584,-12.71384516,2015
8/2/2013,2 Guns,61000000,75612460,14612460,23.95485246,2013
1/11/2019,A Dogâs Way Home,61000000,41952715,-19047285,-31.22505738,2019
10/3/2014,Gone Girl,61000000,167767189,106767189,175.0281787,2014
1/26/2018,Maze Runner: The Death Cure,61000000,58032443,-2967557,-4.864847541,2018
9/18/2015,Maze Runner: The Scorch Trials,61000000,81697192,20697192,33.92982295,2015
2/19/2016,Mei Ren Yu,60720000,3229457,-57490543,-94.68139493,2016
5/25/2017,Baywatch,60000000,58060186,-1939814,-3.233023333,2017
2/8/2019,Cold Pursuit,60000000,32138862,-27861138,-46.43523,2019
9/9/2011,Contagion,60000000,75658097,15658097,26.09682833,2011
8/13/2010,Eat Pray Love,60000000,80574010,20574010,34.29001667,2010
1/29/2010,Edge of Darkness,60000000,43313890,-16686110,-27.81018333,2010
10/12/2018,First Man,60000000,44936545,-15063455,-25.10575833,2018
1/11/2013,Gangster Squad,60000000,46000903,-13999097,-23.33182833,2013
12/21/2012,Jack Reacher,60000000,80070736,20070736,33.45122667,2012
10/21/2016,Jack Reacher: Never Go Back,60000000,58697076,-1302924,-2.17154,2016
1/17/2014,Jack Ryan: Shadow Recruit,60000000,50577412,-9422588,-15.70431333,2014
12/25/2015,Joy,60000000,56451232,-3548768,-5.914613333,2015
3/4/2016,London Has Fallen,60000000,62524260,2524260,4.2071,2016
1/23/2015,Mortdecai,60000000,7696134,-52303866,-87.17311,2015
8/17/2012,ParaNorman,60000000,56003051,-3996949,-6.661581667,2012
5/13/2011,Priest,60000000,29136626,-30863374,-51.43895667,2011
10/15/2010,Red,60000000,90380162,30380162,50.63360333,2010
2/24/2017,Rock Dog,60000000,9420546,-50579454,-84.29909,2017
4/7/2017,Smurfs: The Lost Village,60000000,45020282,-14979718,-24.96619667,2017
9/9/2016,Sully,60000000,125070033,65070033,108.450055,2016
9/26/2014,The Boxtrolls,60000000,50837305,-9162695,-15.27115833,2014
8/4/2017,The Dark Tower,60000000,50701325,-9298675,-15.49779167,2017
2/7/2014,The Lego Movie,60000000,257784718,197784718,329.6411967,2014
8/21/2013,The Mortal Instruments: City of Bones,60000000,31165421,-28834579,-48.05763167,2013
12/11/2015,The Ridiculous 6,60000000,0,-60000000,-100,2015
9/21/2012,Trouble with the Curve,60000000,35763137,-24236863,-40.39477167,2012
12/25/2018,Vice,60000000,47836282,-12163718,-20.27286333,2018
2/14/2014,Winterâs Tale,60000000,12600231,-47399769,-78.999615,2014
2/5/2016,Xi You Ji zhi Sun Wu Kong San Da Bai Gu Jing,60000000,709982,-59290018,-98.81669667,2016
11/8/2019,Midway,59500000,0,-59500000,-100,2019
3/23/2018,Sherlock Gnomes,59000000,43242871,-15757129,-26.70699831,2018
1/25/2019,The Kid Who Would Be King,59000000,16790790,-42209210,-71.5410339,2019
12/25/2014,American Sniper,58000000,350126372,292126372,503.6661586,2014
2/12/2016,Deadpool,58000000,363070709,305070709,525.983981,2016
10/16/2015,Goosebumps,58000000,80069458,22069458,38.05078966,2015
3/24/2017,Life,58000000,30234022,-27765978,-47.87237586,2017
1/20/2012,Red Tails,58000000,49876377,-8123623,-14.00624655,2012
6/7/2013,The Internship,58000000,44672764,-13327236,-22.9779931,2013
9/10/2010,Resident Evil: Afterlife,57500000,60128566,2628566,4.57141913,2010
6/15/2012,That's My Boy,57500000,36931089,-20568911,-35.77201913,2012
2/17/2012,Ghost Rider: Spirit of Vengeance,57000000,51774002,-5225998,-9.168417544,2012
12/25/2014,Into the Woods,56200000,128002372,71802372,127.7622278,2014
1/22/2016,Zhuo yao ji,56000000,32766,-55967234,-99.94148929,2016
2/23/2018,Annihilation,55000000,32732301,-22267699,-40.48672545,2018
11/2/2018,Bohemian Rhapsody,55000000,216303339,161303339,293.2787982,2018
2/1/2013,Bullet to the Head,55000000,9489829,-45510171,-82.74576545,2013
11/24/2010,Burlesque,55000000,39440655,-15559345,-28.28971818,2010
10/11/2013,Captain Phillips,55000000,107136417,52136417,94.79348545,2013
10/16/2015,Crimson Peak,55000000,31090320,-23909680,-43.47214545,2015
4/9/2010,Date Night,55000000,98711404,43711404,79.47528,2010
2/10/2017,Fifty Shades Darker,55000000,114434010,59434010,108.0618364,2017
2/9/2018,Fifty Shades Freed,55000000,100407760,45407760,82.55956364,2018
11/1/2013,Free Birds,55000000,55750480,750480,1.364509091,2013
8/19/2016,Kubo and the Two Strings,55000000,48023088,-6976912,-12.68529455,2016
6/17/2011,Mr. Poppers's Penguins,55000000,68224452,13224452,24.04445818,2011
3/21/2014,Muppets Most Wanted,55000000,51178893,-3821107,-6.947467273,2014
11/10/2017,Murder on the Orient Express,55000000,102826543,47826543,86.95735091,2017
1/16/2015,Paddington,55000000,76223578,21223578,38.58832364,2015
9/26/2014,The Equalizer,55000000,101530738,46530738,84.60134182,2014
4/27/2012,The Pirates! Band of Misfits,55000000,31051126,-23948874,-43.54340727,2012
7/27/2012,The Watch,55000000,34353000,-20647000,-37.54,2012
9/18/2015,Black Mass,53000000,62575678,9575678,18.06731698,2015
12/19/2012,Zero Dark Thirty,52500000,95720716,43220716,82.32517333,2012
2/5/2010,From Paris With Love,52000000,24077427,-27922573,-53.69725577,2010
8/5/2011,The Change-Up,52000000,37243418,-14756582,-28.37804231,2011
2/12/2010,Valentine's Day,52000000,110485654,58485654,112.4724115,2010
8/17/2018,Alpha,51000000,35851379,-15148621,-29.70317843,2018
3/4/2011,The Adjustment Bureau,50200000,62495645,12295645,24.49331673,2011
1/15/2016,13 Hours: The Secret Soldiers of Benghazi,50000000,52853219,2853219,5.706438,2016
6/13/2014,22 Jump Street,50000000,191719337,141719337,283.438674,2014
9/29/2017,American Made,50000000,51342000,1342000,2.684,2017
4/6/2012,American Reunion,50000000,56758835,6758835,13.51767,2012
12/18/2013,Anchorman 2: The Legend Continues,50000000,127352707,77352707,154.705414,2013
11/8/2019,Arctic Dogs,50000000,0,-50000000,-100,2019
2/14/2013,Beautiful Creatures,50000000,19452138,-30547862,-61.095724,2013
6/17/2016,Central Intelligence,50000000,127440871,77440871,154.881742,2016
4/17/2015,Child 44,50000000,1224330,-48775670,-97.55134,2015
7/29/2011,"Crazy, Stupid, Love",50000000,84351197,34351197,68.702394,2011
11/21/2018,Creed II,50000000,115715889,65715889,131.431778,2018
12/25/2015,Daddyâs Home,50000000,150357137,100357137,200.714274,2015
8/9/2013,Disney Planes,50000000,90282580,40282580,80.56516,2013
9/30/2011,Dream House,50000000,21302340,-28697660,-57.39532,2011
2/25/2011,Drive Angry,50000000,10721033,-39278967,-78.557934,2011
2/16/2018,Early Man,50000000,8267544,-41732456,-83.464912,2018
6/24/2016,Free State of Jones,50000000,20810036,-29189964,-58.379928,2016
1/25/2013,Hansel & Gretel: Witch Hunters,50000000,55703475,5703475,11.40695,2013
4/12/2019,Hellboy,50000000,21903748,-28096252,-56.192504,2019
10/15/2010,Hereafter,50000000,32746941,-17253059,-34.506118,2010
2/18/2011,I am Number Four,50000000,55100437,5100437,10.200874,2011
8/8/2014,Into the Storm,50000000,47602194,-2397806,-4.795612,2014
6/4/2010,Marmaduke,50000000,33644788,-16355212,-32.710424,2010
9/23/2011,Moneyball,50000000,75605492,25605492,51.210984,2011
2/28/2014,Non-Stop,50000000,91742160,41742160,83.48432,2014
2/9/2018,Peter Rabbit,50000000,115234093,65234093,130.468186,2018
7/18/2014,Planes: Fire and Rescue,50000000,59157732,9157732,18.315464,2014
3/13/2015,Run All Night,50000000,26461644,-23538356,-47.076712,2015
10/2/2015,Shanghai,50000000,46425,-49953575,-99.90715,2015
9/16/2016,Snowden,50000000,21587519,-28412481,-56.824962,2016
6/10/2011,Super 8,50000000,127004179,77004179,154.008358,2011
6/29/2012,Ted,50000000,218665740,168665740,337.33148,2012
10/17/2014,The Book of Life,50000000,50151543,151543,0.303086,2014
7/28/2017,The Emoji Movie,50000000,86089513,36089513,72.179026,2017
3/29/2013,The Host,50000000,26623701,-23376299,-46.752598,2013
10/10/2014,The Judge,50000000,47119388,-2880612,-5.761224,2014
12/14/2018,The Mule,50000000,103804407,53804407,107.608814,2018
5/20/2016,The Nice Guys,50000000,36261763,-13738237,-27.476474,2016
12/22/2017,The Post,50000000,81903458,31903458,63.806916,2017
11/22/2019,The Rhythm Section,50000000,0,-50000000,-100,2019
3/15/2013,Upside Down,50000000,102118,-49897882,-99.795764,2013
8/19/2016,War Dogs,50000000,43034523,-6965477,-13.930954,2016
12/23/2011,We Bought a Zoo,50000000,75624550,25624550,51.2491,2011
4/8/2011,Your Highness,50000000,21596445,-28403555,-56.80711,2011
2/12/2016,Zoolander 2,50000000,28848693,-21151307,-42.302614,2016
9/20/2019,Ad Astra,49800000,0,-49800000,-100,2019
11/16/2012,Anna Karenina,49000000,12816367,-36183633,-73.84414898,2012
3/6/2015,Chappie,49000000,31569268,-17430732,-35.57292245,2015
11/16/2018,Instant Family,48000000,67363237,19363237,40.34007708,2018
1/9/2015,Taken 3,48000000,89256424,41256424,85.95088333,2015
1/22/2010,Tooth Fairy,48000000,60022256,12022256,25.04636667,2010
7/13/2016,The Infiltrator,47500000,15436808,-32063192,-67.50145684,2016
11/11/2016,Arrival,47000000,100546139,53546139,113.9279553,2016
6/18/2010,Jonah Hex,47000000,10547117,-36452883,-77.55932553,2010
11/1/2013,Mr. Nobody,46500000,3622,-46496378,-99.99221075,2013
12/23/2016,Silence,46500000,7100177,-39399823,-84.73080215,2016
9/20/2013,Prisoners,46000000,61002302,15002302,32.6137,2013
12/31/2010,Arthur and the War of Two Worlds,45500000,347136,-45152864,-99.23706374,2010
6/16/2017,All Eyez on Me,45000000,44922302,-77698,-0.172662222,2017
5/23/2014,Blended,45000000,46290741,1290741,2.868313333,2014
9/21/2012,Dredd,45000000,13414714,-31585286,-70.18952444,2012
12/31/2012,Foodfight!,45000000,0,-45000000,-100,2012
10/21/2011,Johnny English Reborn,45000000,8406711,-36593289,-81.31842,2011
12/9/2016,Office Christmas Party,45000000,54767494,9767494,21.70554222,2016
12/22/2017,Pitch Perfect 3,45000000,104897530,59897530,133.1056222,2017
7/6/2012,Savages,45000000,47323100,2323100,5.162444444,2012
10/5/2012,Taken 2,45000000,139854287,94854287,210.7873044,2012
3/19/2010,The Bounty Hunter,45000000,67061228,22061228,49.02495111,2010
2/19/2010,The Ghost Writer,45000000,15541549,-29458451,-65.46322444,2010
10/7/2016,The Girl on the Train,45000000,75395035,30395035,67.54452222,2016
11/23/2011,The Muppets,45000000,88625922,43625922,96.94649333,2011
10/28/2011,The Rum Diary,45000000,13109815,-31890185,-70.86707778,2011
5/3/2019,UglyDolls,45000000,19894664,-25105336,-55.78963556,2019
12/21/2018,Welcome to Marwen,45000000,10763520,-34236480,-76.08106667,2018
10/12/2012,Argo,44500000,136025503,91525503,205.6752876,2012
7/30/2010,Charlie St. Cloud,44000000,31206263,-12793737,-29.076675,2010
2/6/2014,The Interview,44000000,6105175,-37894825,-86.12460227,2014
1/6/2017,A Monster Calls,43000000,3740823,-39259177,-91.30041163,2017
11/9/2018,The Girl in the Spiderâs Web,43000000,14828555,-28171445,-65.51498837,2018
6/28/2013,The Heat,43000000,159581587,116581587,271.1199698,2013
1/28/2011,The Mechanic,42500000,29121498,-13378502,-31.47882824,2011
3/16/2012,21 Jump Street,42000000,138447667,96447667,229.6373024,2012
10/12/2012,Here Comes the Boom,42000000,45290318,3290318,7.834090476,2012
12/25/2018,Holmes & Watson,42000000,30568743,-11431257,-27.21727857,2018
1/27/2012,Man on a Ledge,42000000,18620000,-23380000,-55.66666667,2012
5/28/2010,Micmacs,42000000,1259693,-40740307,-97.00073095,2010
1/27/2012,One for the Money,42000000,26414527,-15585473,-37.10826905,2012
12/31/2015,Pourquoi j'ai pas mangÃ© mon pÃ¨re,42000000,0,-42000000,-100,2015
3/11/2011,Red Riding Hood,42000000,37662162,-4337838,-10.32818571,2011
5/12/2017,Snatched,42000000,45852178,3852178,9.171852381,2017
12/3/2010,The Warrior's Way,42000000,5666340,-36333660,-86.50871429,2010
5/31/2019,Rocketman,41000000,57342725,16342725,39.86030488,2019
10/14/2011,The Big Year,41000000,7204138,-33795862,-82.42893171,2011
5/30/2014,A Million Ways to Die in The West,40000000,42720965,2720965,6.8024125,2014
3/9/2012,A Thousand Words,40000000,18450127,-21549873,-53.8746825,2012
12/13/2013,American Hustle,40000000,150117807,110117807,275.2945175,2013
4/8/2011,Arthur,40000000,33035397,-6964603,-17.4115075,2011
7/10/2015,Baahubali: The Beginning,40000000,6738000,-33262000,-83.155,2015
2/3/2012,Big Miracle,40000000,20157300,-19842700,-49.60675,2012
11/11/2016,Billy Lynnâs Long Halftime Walk,40000000,1738477,-38261523,-95.6538075,2016
10/16/2015,Bridge of Spies,40000000,72313754,32313754,80.784385,2015
8/26/2011,Colombiana,40000000,36665854,-3334146,-8.335365,2011
12/31/2019,Down Under Cover,40000000,0,-40000000,-100,2019
12/31/2014,Dragon Nest Warriors' Dawn,40000000,0,-40000000,-100,2014
11/14/2014,Dumb and Dumber To,40000000,86208010,46208010,115.520025,2014
2/15/2013,Escape From Planet Earth,40000000,57012977,17012977,42.5324425,2013
12/25/2011,Extremely Loud and Incredibly Close,40000000,31847881,-8152119,-20.3802975,2011
2/13/2015,Fifty Shades of Grey,40000000,166167230,126167230,315.418075,2015
8/12/2011,Final Destination 5,40000000,42587643,2587643,6.4691075,2011
3/27/2015,Get Hard,40000000,90411453,50411453,126.0286325,2015
6/4/2010,Get Him to the Greek,40000000,61153526,21153526,52.883815,2010
12/25/2013,Grudge Match,40000000,29807260,-10192740,-25.48185,2013
11/4/2016,Hacksaw Ridge,40000000,67209615,27209615,68.0240375,2016
11/26/2014,Horrible Bosses 2,40000000,54445357,14445357,36.1133925,2014
6/20/2014,Jersey Boys,40000000,47047013,7047013,17.6175325,2014
5/17/2019,John Wick: Chapter 3 â Parabellum,40000000,141744320,101744320,254.3608,2019
2/10/2017,John Wick: Chapter Two,40000000,92029184,52029184,130.07296,2017
6/21/2019,Kursk,40000000,0,-40000000,-100,2019
12/25/2013,Lone Survivor,40000000,125095601,85095601,212.7390025,2013
5/3/2019,Long Shot,40000000,30202860,-9797140,-24.49285,2019
7/25/2014,Lucy,40000000,126573960,86573960,216.4349,2014
8/26/2016,Mechanic: Resurrection,40000000,21218403,-18781597,-46.9539925,2016
11/10/2010,Morning Glory,40000000,31011732,-8988268,-22.47067,2010
8/16/2013,Paranoia,40000000,7388654,-32611346,-81.528365,2013
12/21/2016,Patriots Day,40000000,31886361,-8113639,-20.2840975,2016
3/18/2011,Paul,40000000,37412945,-2587055,-6.4676375,2011
7/9/2010,Predators,40000000,52000688,12000688,30.00172,2010
1/27/2017,Resident Evil: The Final Chapter,40000000,26844692,-13155308,-32.88827,2017
1/15/2016,Ride Along 2,40000000,90862685,50862685,127.1567125,2016
4/15/2011,Scream 4,40000000,38180928,-1819072,-4.54768,2011
1/7/2011,Season of the Witch,40000000,24827228,-15172772,-37.93193,2011
7/18/2014,Sex Tape,40000000,38543473,-1456527,-3.6413175,2014
6/27/2014,Snowpiercer,40000000,4563029,-35436971,-88.5924275,2014
10/14/2016,The Accountant,40000000,86260045,46260045,115.6501125,2016
1/12/2018,The Commuter,40000000,36343858,-3656142,-9.140355,2018
6/10/2016,The Conjuring 2: The Enfield Poltergeist,40000000,102470008,62470008,156.17502,2016
12/31/2018,The Crow,40000000,0,-40000000,-100,2018
9/13/2019,The Goldfinch,40000000,0,-40000000,-100,2019
12/19/2012,The Guilt Trip,40000000,37134215,-2865785,-7.1644625,2012
3/20/2015,The Gunman,40000000,10664749,-29335251,-73.3381275,2015
6/30/2017,The House,40000000,25584504,-14415496,-36.03874,2017
9/21/2018,The House with a Clock in its Walls,40000000,68549695,28549695,71.3742375,2018
3/9/2018,The Hurricane Heist,40000000,6115824,-33884176,-84.71044,2018
12/21/2012,The Impossible,40000000,19019882,-20980118,-52.450295,2012
9/25/2015,The Intern,40000000,75764672,35764672,89.41168,2015
6/11/2010,The Karate Kid,40000000,176591618,136591618,341.479045,2010
3/18/2011,The Lincoln Lawyer,40000000,58009200,18009200,45.023,2011
8/11/2017,The Nut Job 2: Nutty by Nature,40000000,28370522,-11629478,-29.073695,2017
8/15/2012,The Odd Life of Timothy Green,40000000,51853450,11853450,29.633625,2012
4/25/2014,The Other Woman,40000000,83911193,43911193,109.7779825,2014
10/1/2010,The Social Network,40000000,96962694,56962694,142.406735,2010
4/16/2013,Un monstre Ã Paris,40000000,0,-40000000,-100,2013
2/18/2011,Unknown,40000000,63686397,23686397,59.2159925,2011
11/11/2016,USS Indianapolis: Men of Courage,40000000,0,-40000000,-100,2016
11/25/2015,Victor Frankenstein,40000000,5775076,-34224924,-85.56231,2015
11/16/2018,Widows,40000000,42402632,2402632,6.00658,2018
10/5/2012,Frankenweenie,39000000,35287788,-3712212,-9.518492308,2012
8/23/2013,Yi dai zong shi,38600000,6594959,-32005041,-82.91461399,2013
6/2/2017,Captain Underpants: The First Epic Movie,38000000,73921000,35921000,94.52894737,2017
10/8/2010,Life as We Know It,38000000,53374681,15374681,40.45968684,2010
10/20/2017,Only the Brave,38000000,18340051,-19659949,-51.73670789,2017
4/17/2015,Paul Blart: Mall Cop 2,38000000,71091594,33091594,87.08314211,2015
9/6/2013,Riddick,38000000,42025135,4025135,10.59246053,2013
9/20/2013,Rush,38000000,26947624,-11052376,-29.0852,2013
1/22/2016,The 5th Wave,38000000,34912982,-3087018,-8.123731579,2016
9/21/2018,The Sisters Brothers,38000000,3143056,-34856944,-91.7288,2018
10/14/2011,The Thing,38000000,16999934,-21000066,-55.26333158,2011
4/22/2011,Water for Elephants,38000000,58709717,20709717,54.49925526,2011
12/23/2016,Why Him?,38000000,60323786,22323786,58.74680526,2016
9/14/2012,The Master,37500000,16247159,-21252841,-56.67424267,2012
1/11/2019,The Upside,37500000,108235497,70735497,188.627992,2019
5/18/2012,What to Expect When You're Expecting,37500000,41152203,3652203,9.739208,2012
5/29/2015,Aloha,37000000,21052030,-15947970,-43.10262162,2015
2/26/2010,Cop Out,37000000,44875481,7875481,21.28508378,2010
11/25/2015,Creed,37000000,109767581,72767581,196.6691378,2015
9/23/2011,Dolphin Tale,37000000,72286779,35286779,95.36967297,2011
2/23/2018,Game Night,37000000,69179066,32179066,86.97044865,2018
2/12/2016,How to be Single,37000000,46843513,9843513,26.60408919,2016
1/28/2011,The Rite,37000000,33047633,-3952367,-10.68207297,2011
9/17/2010,The Town,37000000,92186262,55186262,149.1520595,2010
8/7/2013,We're the Millers,37000000,150394119,113394119,306.4705919,2013
10/5/2018,A Star is Born,36000000,215288866,179288866,498.0246278,2018
12/16/2016,Collateral Beauty,36000000,31016021,-4983979,-13.84438611,2016
9/12/2014,Dolphin Tale 2,36000000,42024533,6024533,16.73481389,2014
2/11/2011,Gnomeo and Juliet,36000000,99967670,63967670,177.6879722,2011
3/26/2010,Hot Tub Time Machine,36000000,50269859,14269859,39.63849722,2010
4/14/2017,Queen of the Desert,36000000,0,-36000000,-100,2017
5/6/2011,There Be Dragons,36000000,1069334,-34930666,-97.02962778,2011
1/22/2016,Yip Man 3,36000000,2679437,-33320563,-92.55711944,2016
1/19/2018,12 Strong,35000000,45819713,10819713,30.91346571,2018
4/22/2016,A Hologram for the King,35000000,4212494,-30787506,-87.96430286,2016
4/30/2010,A Nightmare on Elm Street,35000000,63075011,28075011,80.21431714,2010
9/23/2011,Abduction,35000000,28087155,-6912845,-19.75098571,2011
6/1/2018,Adrift,35000000,31445011,-3554989,-10.15711143,2018
10/19/2012,Alex Cross,35000000,25888412,-9111588,-26.03310857,2012
1/28/2011,Biutiful,35000000,5101237,-29898763,-85.42503714,2011
9/16/2016,Bridget Jonesâs Baby,35000000,24139805,-10860195,-31.02912857,2016
1/18/2013,Broken City,35000000,19701164,-15298836,-43.71096,2013
12/25/2015,Concussion,35000000,34531832,-468168,-1.337622857,2015
7/22/2011,Friends with Benefits,35000000,55802754,20802754,59.43644,2011
4/30/2010,Furry Vengeance,35000000,17630465,-17369535,-49.62724286,2010
10/12/2018,Goosebumps 2: Haunted Halloween,35000000,46697321,11697321,33.42091714,2018
8/21/2015,Hitman: Agent 47,35000000,22467450,-12532550,-35.80728571,2015
7/8/2011,Horrible Bosses,35000000,117538559,82538559,235.8244543,2011
5/8/2015,Hot Pursuit,35000000,34580201,-419799,-1.199425714,2015
2/8/2013,Identity Thief,35000000,134506920,99506920,284.3054857,2013
10/28/2011,In Time,35000000,37553932,2553932,7.296948571,2011
9/8/2017,It,35000000,327481748,292481748,835.6621371,2017
11/9/2011,J. Edgar,35000000,37306030,2306030,6.588657143,2011
11/29/2013,Mandela: Long Walk to Freedom,35000000,8323085,-26676915,-76.21975714,2013
8/17/2018,Mile 22,35000000,36108758,1108758,3.16788,2018
8/20/2010,Nanny McPhee and the Big Bang,35000000,29197642,-5802358,-16.57816571,2010
5/20/2016,Neighbors 2: Sorority Rising,35000000,55340730,20340730,58.11637143,2016
1/25/2013,Parker,35000000,17616641,-17383359,-49.66674,2013
5/22/2015,Poltergeist,35000000,47425125,12425125,35.50035714,2015
8/24/2012,Premium Rush,35000000,20275446,-14724554,-42.07015429,2012
3/28/2014,Sabotage,35000000,10508518,-24491482,-69.97566286,2014
12/13/2013,Saving Mr. Banks,35000000,83299761,48299761,137.9993171,2013
10/8/2010,Secretariat,35000000,59699513,24699513,70.57003714,2010
6/29/2018,Sicario: Day of the Soldado,35000000,50065850,15065850,43.04528571,2018
5/6/2011,Something Borrowed,35000000,39046489,4046489,11.56139714,2011
9/14/2012,Stolen,35000000,289773,-34710227,-99.17207714,2012
4/23/2010,The Back-up Plan,35000000,37490007,2490007,7.114305714,2010
3/11/2016,The Brothers Grimsby,35000000,6864016,-28135984,-80.38852571,2016
10/13/2017,The Foreigner,35000000,34393507,-606493,-1.732837143,2017
3/13/2015,The Lovers,35000000,0,-35000000,-100,2015
10/20/2017,The Snowman,35000000,6670765,-28329235,-80.94067143,2017
5/27/2011,The Tree of Life,35000000,13305665,-21694335,-61.98381429,2011
9/30/2015,The Walk,35000000,10161183,-24838817,-70.96804857,2015
12/21/2012,This is 40,35000000,67544505,32544505,92.9843,2012
7/17/2015,Trainwreck,35000000,110212700,75212700,214.8934286,2015
10/14/2011,Trespass,35000000,16816,-34983184,-99.95195429,2011
12/22/2010,True Grit,35000000,171243005,136243005,389.2657286,2010
1/6/2017,Underworld: Blood Wars,35000000,30353973,-4646027,-13.27436286,2017
3/6/2015,Unfinished Business,35000000,10219501,-24780499,-70.80142571,2015
3/4/2016,Whiskey Tango Foxtrot,35000000,23083334,-11916666,-34.04761714,2016
12/25/2011,The Darkest Hour,34800000,21443494,-13356506,-38.38076437,2011
6/28/2017,Baby Driver,34000000,107825862,73825862,217.1348882,2017
8/3/2018,The Darkest Minds,34000000,12695691,-21304309,-62.65973235,2018
4/10/2015,The Longest Ride,34000000,37446117,3446117,10.13563824,2015
9/19/2014,The Maze Runner,34000000,102427862,68427862,201.2584176,2014
9/5/2014,Thunder and the House of Magic,34000000,4091,-33995909,-99.98796765,2014
10/30/2015,Freaks of Nature,33000000,70958,-32929042,-99.78497576,2015
7/8/2016,Mike and Dave Need Wedding Dates,33000000,46009673,13009673,39.42325152,2016
4/27/2012,Safe,33000000,17142080,-15857920,-48.05430303,2012
7/27/2012,Step Up Revolution,33000000,35074677,2074677,6.2869,2012
7/31/2015,The Young and Prodigious T.S. Spivet,33000000,176847,-32823153,-99.4641,2015
5/13/2011,Bridesmaids,32500000,169211718,136711718,420.65144,2011
4/26/2013,The Big Wedding,32500000,21819348,-10680652,-32.86354462,2013
2/24/2012,Wanderlust,32500000,17288155,-15211845,-46.80567692,2012
10/12/2018,Bad Times at the El Royale,32000000,17839115,-14160885,-44.25276563,2018
2/18/2011,"Big Mommas: Like Father, Like Son",32000000,37915414,5915414,18.48566875,2011
9/3/2010,Going the Distance,32000000,17804299,-14195701,-44.36156563,2010
4/20/2018,I Feel Pretty,32000000,48795601,16795601,52.48625313,2018
3/19/2010,Repo Men,32000000,13942007,-18057993,-56.43122813,2010
4/1/2011,Source Code,32000000,54712227,22712227,70.97570938,2011
8/27/2010,Takers,32000000,57744720,25744720,80.45225,2010
3/15/2013,The Incredible Burt Wonderstone,32000000,22537881,-9462119,-29.56912187,2013
6/12/2013,This is the End,32000000,101470202,69470202,217.0943813,2013
4/15/2016,Criminal,31500000,14708696,-16791304,-53.30572698,2016
4/12/2013,42,31000000,95020213,64020213,206.5168161,2013
8/25/2017,Birth of the Dragon,31000000,6901965,-24098035,-77.73559677,2017
1/22/2010,Extraordinary Measures,31000000,12482741,-18517259,-59.73309355,2010
11/2/2012,Flight,31000000,93772375,62772375,202.4915323,2012
2/13/2019,Isnât it Romantic,31000000,48791187,17791187,57.39092581,2019
3/7/2014,The Grand Budapest Hotel,31000000,59076019,28076019,90.56780323,2014
7/29/2015,Vacation,31000000,58884188,27884188,89.94899355,2015
7/28/2017,Atomic Blonde,30000000,51573925,21573925,71.91308333,2017
4/28/2017,Baahubali 2: The Conclusion,30000000,18985794,-11014206,-36.71402,2017
8/25/2017,Ballerina,30000000,21858070,-8141930,-27.13976667,2017
1/14/2011,Barney's Version,30000000,7502560,-22497440,-74.99146667,2011
2/2/2018,Bilal: A New Breed of Hero,30000000,490973,-29509027,-98.36342333,2018
10/18/2013,Carrie,30000000,35266619,5266619,17.55539667,2013
8/15/2018,Crazy Rich Asians,30000000,174532921,144532921,481.7764033,2018
11/22/2017,Darkest Hour,30000000,56443120,26443120,88.14373333,2017
3/8/2013,Dead Man Down,30000000,10895295,-19104705,-63.68235,2013
3/2/2018,Death Wish,30000000,34017028,4017028,13.39009333,2018
7/2/2014,Deliver Us from Evil,30000000,30577122,577122,1.92374,2014
1/19/2018,Den of Thieves,30000000,44947622,14947622,49.82540667,2018
6/3/2015,Entourage,30000000,32363404,2363404,7.878013333,2015
8/19/2011,Fright Night,30000000,18298649,-11701351,-39.00450333,2011
8/1/2014,Get on Up,30000000,30569935,569935,1.899783333,2014
12/1/2015,Grace of Monaco,30000000,0,-30000000,-100,2015
4/8/2011,Hanna,30000000,40259119,10259119,34.19706333,2011
4/29/2011,Hoodwinked Too: Hood vs. Evil,30000000,10143779,-19856221,-66.18740333,2011
8/8/2012,Hope Springs,30000000,63536011,33536011,111.7867033,2012
10/24/2014,John Wick,30000000,43037835,13037835,43.45945,2014
8/31/2018,Kin,30000000,5718096,-24281904,-80.93968,2018
12/31/2010,Konferenz der Tiere,30000000,0,-30000000,-100,2010
7/1/2011,Larry Crowne,30000000,35608245,5608245,18.69415,2011
2/19/2010,Le Petit Nicolas,30000000,201857,-29798143,-99.32714333,2010
8/16/2013,Lee Daniels' The Butler,30000000,116632095,86632095,288.77365,2013
5/14/2010,Letters to Juliet,30000000,53032453,23032453,76.77484333,2010
5/11/2018,Life of the Party,30000000,53059911,23059911,76.86637,2018
9/28/2012,Looper,30000000,66486205,36486205,121.6206833,2012
11/24/2010,Love and Other Drugs,30000000,32367005,2367005,7.890016667,2010
9/23/2011,Machine Gun Preacher,30000000,538690,-29461310,-98.20436667,2011
5/20/2011,Midnight in Paris,30000000,56816662,26816662,89.38887333,2011
12/25/2017,Mollyâs Game,30000000,28780744,-1219256,-4.064186667,2017
9/15/2017,mother!,30000000,17800004,-12199996,-40.66665333,2017
1/12/2018,Proud Mary,30000000,20868638,-9131362,-30.43787333,2018
10/4/2013,Runner Runner,30000000,19316646,-10683354,-35.61118,2013
2/4/2011,Sanctum,30000000,23209310,-6790690,-22.63563333,2011
3/8/2016,Savva. Serdtse voyna,30000000,0,-30000000,-100,2016
6/14/2019,Shaft,30000000,600000,-29400000,-98,2019
9/18/2015,Sicario,30000000,46889293,16889293,56.29764333,2015
2/8/2013,Side Effects,30000000,32172757,2172757,7.242523333,2013
12/18/2015,Sisters,30000000,87044645,57044645,190.1488167,2015
7/24/2015,Southpaw,30000000,52421953,22421953,74.73984333,2015
12/31/2013,Space Pirate Captain Harlock,30000000,0,-30000000,-100,2013
6/4/2010,Splice,30000000,17010170,-12989830,-43.29943333,2010
8/6/2010,Step Up 3D,30000000,42400223,12400223,41.33407667,2010
10/9/2015,Steve Jobs,30000000,17766658,-12233342,-40.77780667,2015
9/22/2017,Stronger,30000000,4211129,-25788871,-85.96290333,2017
2/9/2018,The 15:17 to Paris,30000000,36276286,6276286,20.92095333,2018
4/24/2015,The Age of Adaline,30000000,42629776,12629776,42.09925333,2015
4/13/2012,The Cabin in the Woods,30000000,42073277,12073277,40.24425667,2012
9/13/2013,The Family,30000000,36918811,6918811,23.06270333,2013
4/27/2012,The Five-Year Engagement,30000000,28700285,-1299715,-4.332383333,2012
8/18/2017,The Hitmanâs Bodyguard,30000000,75468583,45468583,151.5619433,2017
1/18/2013,The Last Stand,30000000,12050299,-17949701,-59.83233667,2013
4/14/2017,The Lost City of Z,30000000,8574339,-21425661,-71.41887,2017
11/19/2010,The Next Three Days,30000000,21148651,-8851349,-29.50449667,2010
1/17/2014,The Nut Job,30000000,64251538,34251538,114.1717933,2014
2/3/2017,The Space Between Us,30000000,7885294,-22114706,-73.71568667,2017
4/13/2012,The Three Stooges,30000000,44338224,14338224,47.79408,2012
2/10/2012,The Vow,30000000,125014030,95014030,316.7134333,2012
6/5/2015,United Passions,30000000,918,-29999082,-99.99694,2015
2/1/2013,Warm Bodies,30000000,66380662,36380662,121.2688733,2013
9/14/2018,White Boy Rick,30000000,24004833,-5995167,-19.98389,2018
1/30/2015,Wild Card,30000000,3200,-29996800,-99.98933333,2015
7/15/2011,Winnie the Pooh,30000000,26692846,-3307154,-11.02384667,2011
10/7/2011,Xinhai geming,30000000,135739,-29864261,-99.54753667,2011
2/24/2017,Collide,29200000,2280004,-26919996,-92.19176712,2017
8/12/2016,Florence Foster Jenkins,29000000,27383770,-1616230,-5.573206897,2016
8/18/2017,Logan Lucky,29000000,27778642,-1221358,-4.21157931,2017
9/28/2018,Night School,29000000,77339130,48339130,166.6866552,2018
5/15/2015,Pitch Perfect 2,29000000,184296230,155296230,535.5042414,2015
4/8/2016,The Boss,29000000,63077560,34077560,117.5088276,2016
9/30/2019,Unhinged,29000000,0,-29000000,-100,2019
2/21/2014,3 Days to Kill,28000000,30697999,2697999,9.635710714,2014
8/12/2011,30 Minutes or Less,28000000,37053924,9053924,32.33544286,2011
11/1/2017,A Bad Moms Christmas,28000000,72110659,44110659,157.5380679,2017
9/19/2014,A Walk Among the Tombstones,28000000,26017685,-1982315,-7.079696429,2014
10/10/2014,"Alexander and the Terrible, Horrible, No Good, Very Bad Day",28000000,66954149,38954149,139.1219607,2014
8/21/2015,American Ultra,28000000,14439985,-13560015,-48.428625,2015
4/25/2014,Brick Mansions,28000000,20396829,-7603171,-27.15418214,2014
7/21/2017,Girls Trip,28000000,115108515,87108515,311.1018393,2017
4/16/2010,Kick-Ass,28000000,48071303,20071303,71.683225,2010
8/16/2013,Kick-Ass 2,28000000,28795985,795985,2.842803571,2013
1/28/2013,Last Vegas,28000000,63914167,35914167,128.2648821,2013
10/30/2015,Our Brand is Crisis,28000000,7002261,-20997739,-74.991925,2015
2/5/2016,Pride and Prejudice and Zombies,28000000,10907291,-17092709,-61.04538929,2016
2/14/2013,Safe Haven,28000000,71399120,43399120,154.9968571,2013
8/14/2015,Straight Outta Compton,28000000,161197785,133197785,475.706375,2015
6/15/2018,Tag,28000000,54730625,26730625,95.46651786,2018
12/11/2015,The Big Short,28000000,70259870,42259870,150.9281071,2015
1/15/2010,The Spy Next Door,28000000,24307106,-3692894,-13.18890714,2010
10/28/2011,Anonymous,27500000,4463292,-23036708,-83.76984727,2011
1/13/2012,Joyful Noise,27500000,30932113,3432113,12.48041091,2012
10/1/2010,Case 39,27000000,13261851,-13738149,-50.88203333,2010
3/18/2011,Limitless,27000000,79249455,52249455,193.5165,2011
5/13/2016,Money Monster,27000000,41012075,14012075,51.89657407,2016
8/19/2011,Spy Kids: All the Time in the World,27000000,38536376,11536376,42.72731852,2011
11/23/2016,Rules Donât Apply,26700000,3652206,-23047794,-86.32132584,2016
3/17/2015,Accidental Love,26000000,0,-26000000,-100,2015
3/21/2014,Blood Ties,26000000,42472,-25957528,-99.83664615,2014
8/29/2012,Lawless,26000000,37397291,11397291,43.83573462,2012
1/22/2010,Legion,26000000,40168080,14168080,54.49261538,2010
12/9/2011,New Yearâs Eve,26000000,54544638,28544638,109.7870692,2011
4/26/2013,Pain & Gain,26000000,49875291,23875291,91.82804231,2013
7/10/2015,Self/Less,26000000,12279691,-13720309,-52.77041923,2015
10/17/2014,The Best of Me,26000000,26766213,766213,2.946973077,2014
4/24/2015,The Face of an Angel,26000000,0,-26000000,-100,2015
10/18/2013,The Fifth Estate,26000000,3254172,-22745828,-87.48395385,2013
4/27/2012,The Raven,26000000,16008272,-9991728,-38.42972308,2012
6/30/2015,Viy,26000000,0,-26000000,-100,2015
1/27/2017,A Dogâs Purpose,25000000,64321890,39321890,157.28756,2017
12/25/2013,August: Osage County,25000000,37738810,12738810,50.95524,2013
9/22/2017,Battle of the Sexes,25000000,12638526,-12361474,-49.445896,2017
10/12/2018,Beautiful Boy,25000000,7634767,-17365233,-69.460932,2018
12/31/2010,Belka i Strelka. Zvezdnye sobaki,25000000,0,-25000000,-100,2010
3/15/2019,Captive State,25000000,5958315,-19041685,-76.16674,2019
12/16/2011,Carnage,25000000,2546747,-22453253,-89.813012,2011
3/24/2017,CHiPS,25000000,18600152,-6399848,-25.599392,2017
12/21/2012,Cirque du Soleil: Worlds Away,25000000,12512862,-12487138,-49.948552,2012
1/13/2012,Contraband,25000000,66528000,41528000,166.112,2012
2/5/2010,Dear John,25000000,80014842,55014842,220.059368,2010
8/26/2011,Don't Be Afraid of the Dark,25000000,24046682,-953318,-3.813272,2011
4/11/2014,Draft Day,25000000,28842237,3842237,15.368948,2014
12/22/2017,Father Figures,25000000,17501244,-7498756,-29.995024,2017
2/17/2017,Fist Fight,25000000,32187017,7187017,28.748068,2017
12/25/2016,Hidden Figures,25000000,169607287,144607287,578.429148,2016
7/8/2011,Ironclad,25000000,0,-25000000,-100,2011
1/29/2016,Jane Got a Gun,25000000,1513793,-23486207,-93.944828,2016
10/4/2011,La vÃ©ritable histoire du Chat BottÃ©,25000000,0,-25000000,-100,2011
11/20/2015,Legend,25000000,1872994,-23127006,-92.508024,2015
8/24/2012,Les petits mouchoirs,25000000,205505,-24794495,-99.17798,2012
6/30/2010,Love Ranch,25000000,137885,-24862115,-99.44846,2010
4/22/2011,Madea's Big Happy Family,25000000,53345287,28345287,113.381148,2011
12/7/2018,Mary Queen of Scots,25000000,16468499,-8531501,-34.126004,2018
12/31/2017,Matilda,25000000,0,-25000000,-100,2017
5/16/2014,Million Dollar Arm,25000000,36447959,11447959,45.791836,2014
4/29/2016,Motherâs Day,25000000,32492859,7492859,29.971436,2016
10/8/2010,My Soul to Take,25000000,14744435,-10255565,-41.02226,2010
1/21/2011,No Strings Attached,25000000,70662220,45662220,182.64888,2011
3/22/2013,On the Road,25000000,720828,-24279172,-97.116688,2013
12/25/2012,Parental Guidance,25000000,77267296,52267296,209.069184,2012
9/7/2018,Peppermint,25000000,35418723,10418723,41.674892,2018
12/31/2019,Reagan,25000000,0,-25000000,-100,2019
3/10/2015,Red Sky,25000000,0,-25000000,-100,2015
1/17/2014,Ride Along,25000000,134202565,109202565,436.81026,2014
2/3/2017,Rings,25000000,27793018,2793018,11.172072,2017
12/31/2010,Sammy's avonturen: De geheime doorgang,25000000,0,-25000000,-100,2010
1/25/2019,Serenity,25000000,8547045,-16452955,-65.81182,2019
4/13/2018,Sgt. Stubby: An American Hero,25000000,3054285,-21945715,-87.78286,2018
9/2/2011,Shark Night 3D,25000000,18877153,-6122847,-24.491388,2011
8/5/2015,Shaun the Sheep,25000000,19375982,-5624018,-22.496072,2015
9/16/2011,Straw Dogs,25000000,10324441,-14675559,-58.702236,2011
11/13/2015,The 33,25000000,12227722,-12772278,-51.089112,2015
1/10/2014,The Adventurer: The Curse of the Midas Box,25000000,0,-25000000,-100,2014
4/15/2011,The Conspirator,25000000,11538204,-13461796,-53.847184,2011
10/25/2013,The Counselor,25000000,16973715,-8026285,-32.10514,2013
2/11/2011,The Eagle,25000000,19490041,-5509959,-22.039836,2011
12/10/2014,The Gambler,25000000,33680992,8680992,34.723968,2014
8/15/2014,The Giver,25000000,45090374,20090374,80.361496,2014
1/27/2012,The Grey,25000000,51580136,26580136,106.320544,2012
8/10/2011,The Help,25000000,169705587,144705587,578.822348,2011
4/23/2010,The Losers,25000000,23591432,-1408568,-5.634272,2010
4/20/2012,The Lucky One,25000000,60457138,35457138,141.828552,2012
11/20/2015,The Night Before,25000000,43035725,18035725,72.1429,2015
5/10/2019,The Professor and the Madman,25000000,0,-25000000,-100,2019
12/9/2011,The Sitter,25000000,30542576,5542576,22.170304,2011
9/1/2017,Tulip Fever,25000000,2455635,-22544365,-90.17746,2017
12/13/2013,Tyler Perry's A Madea Christmas,25000000,52543354,27543354,110.173416,2013
9/9/2011,Warrior,25000000,13657115,-11342885,-45.37154,2011
4/24/2015,Yi ge ren de wu lin,25000000,129115,-24870885,-99.48354,2015
11/9/2012,Dangerous Liaisons,24200000,17000,-24183000,-99.92975207,2012
12/20/2013,Dhoom 3,24000000,8031955,-15968045,-66.53352083,2013
11/24/2010,Faster,24000000,23240020,-759980,-3.166583333,2010
12/16/2016,Fences,24000000,57682904,33682904,140.3454333,2016
10/14/2011,Footloose,24000000,51802742,27802742,115.8447583,2011
4/7/2017,Going in Style,24000000,45018541,21018541,87.57725417,2017
9/16/2011,I Don't Know How She Does It,24000000,9659074,-14340926,-59.75385833,2011
8/20/2010,Piranha 3D,24000000,25003155,1003155,4.1798125,2010
6/20/2014,Think Like a Man Too,24000000,65028687,41028687,170.9528625,2014
5/5/2017,ChÄi dÃ n zhuÄnjiÄ,23000000,0,-23000000,-100,2017
2/26/2016,Eddie the Eagle,23000000,15789389,-7210611,-31.35048261,2016
11/16/2018,Green Book,23000000,85080171,62080171,269.913787,2018
1/20/2012,Haywire,23000000,18942396,-4057604,-17.64175652,2012
1/10/2014,Her,23000000,25568251,2568251,11.1663087,2014
2/17/2012,Kari gurashi no Arietti,23000000,19192510,-3807490,-16.55430435,2012
6/28/2013,Redemption,23000000,36686,-22963314,-99.84049565,2013
3/15/2011,Shi Yue Wei Cheng,23000000,0,-23000000,-100,2011
10/5/2018,The Hate U Give,23000000,29719483,6719483,29.21514348,2018
10/7/2011,The Ides of March,23000000,40962534,17962534,78.09797391,2011
1/16/2015,The Wedding Ringer,23000000,64460211,41460211,180.261787,2015
11/18/2016,Nocturnal Animals,22500000,10663357,-11836643,-52.60730222,2016
4/24/2015,The Water Diviner,22500000,4200117,-18299883,-81.33281333,2015
10/31/2014,Before I Go to Sleep,22000000,3242457,-18757543,-85.26155909,2014
11/22/2013,Delivery Man,22000000,30659817,8659817,39.36280455,2013
8/3/2012,Diary of a Wimpy Kid: Dog Days,22000000,49008662,27008662,122.7666455,2012
5/19/2017,Diary of a Wimpy Kid: The Long Haul,22000000,20738724,-1261276,-5.733072727,2017
2/5/2016,"Hail, Caesar!",22000000,30080225,8080225,36.72829545,2016
8/22/2012,Hit & Run,22000000,13749300,-8250700,-37.50318182,2012
11/27/2013,Homefront,22000000,20158492,-1841508,-8.370490909,2013
12/8/2017,Just Getting Started,22000000,6069605,-15930395,-72.41088636,2017
12/31/2013,Metegol,22000000,0,-22000000,-100,2013
12/4/2013,Out of the Furnace,22000000,11330849,-10669151,-48.49614091,2013
11/17/2017,"Roman J. Israel, Esq.",22000000,11962712,-10037288,-45.62403636,2017
2/28/2014,Son of God,22000000,59700064,37700064,171.3639273,2014
10/8/2010,Stone,22000000,1810078,-20189922,-91.77237273,2010
8/8/2014,The Hundred-Foot Journey,22000000,54235441,32235441,146.5247318,2014
9/4/2015,The Transporter Refueled,22000000,16029670,-5970330,-27.13786364,2015
6/22/2012,To Rome with Love,21500000,16684352,-4815648,-22.39836279,2012
2/24/2017,Bitter Harvest,21000000,557241,-20442759,-97.34647143,2017
4/6/2018,Blockers,21000000,60311495,39311495,187.1975952,2018
4/16/2010,Death at a Funeral,21000000,42739347,21739347,103.5207,2010
11/5/2010,For Colored Girls,21000000,37729698,16729698,79.66522857,2010
8/4/2017,Kidnap,21000000,30718107,9718107,46.2767,2017
4/5/2019,Pet Sematary,21000000,54724696,33724696,160.5937905,2019
11/16/2012,Silver Linings Playbook,21000000,132092958,111092958,529.0140857,2012
5/6/2011,The Beaver,21000000,970816,-20029184,-95.37706667,2011
12/9/2011,Tinker Tailor Soldier Spy,21000000,24149393,3149393,14.99710952,2011
2/1/2019,Velvet Buzzsaw,21000000,0,-21000000,-100,2019
9/22/2017,Victoria and Abdul,21000000,22245070,1245070,5.928904762,2017
10/18/2013,12 Years a Slave,20000000,56671993,36671993,183.359965,2013
11/23/2011,A Dangerous Method,20000000,5702083,-14297917,-71.489585,2011
12/31/2014,A Most Violent Year,20000000,5749134,-14250866,-71.25433,2014
9/14/2018,A Simple Favor,20000000,53548586,33548586,167.74293,2018
11/4/2011,A Very Harold & Kumar 3D Christmas,20000000,35061031,15061031,75.305155,2011
3/30/2018,Acrimony,20000000,43549096,23549096,117.74548,2018
12/3/2010,All Good Things,20000000,582024,-19417976,-97.08988,2010
9/17/2010,Alpha and Omega 3D,20000000,25107267,5107267,25.536335,2010
7/29/2016,Bad Moms,20000000,113257297,93257297,466.286485,2016
4/15/2016,Barbershop: The Next Cut,20000000,54030051,34030051,170.150255,2016
9/20/2013,Battle of the Year,20000000,8888355,-11111645,-55.558225,2013
10/30/2015,Burnt,20000000,13651946,-6348054,-31.74027,2015
11/13/2015,By the Sea,20000000,538460,-19461540,-97.3077,2015
10/26/2012,Chasing Mavericks,20000000,6002756,-13997244,-69.98622,2012
1/8/2010,Daybreakers,20000000,30101577,10101577,50.507885,2010
8/29/2014,Dwegons and Leprechauns,20000000,0,-20000000,-100,2014
4/29/2011,Dylan Dog: Dead of Night,20000000,1186538,-18813462,-94.06731,2011
2/14/2014,Endless Love,20000000,23438250,3438250,17.19125,2014
7/22/2016,Fight Valley,20000000,0,-20000000,-100,2016
9/29/2017,Flatliners,20000000,16883115,-3116885,-15.584425,2017
1/18/2019,Glass,20000000,111035005,91035005,455.175025,2019
8/26/2016,Hands of Stone,20000000,4712792,-15287208,-76.43604,2016
12/12/2014,Inherent Vice,20000000,8110975,-11889025,-59.445125,2014
10/15/2010,Jackass 3D,20000000,117229692,97229692,486.14846,2010
4/28/2017,JÃ¬yÃ¬ dÃ shÄ«,20000000,587470,-19412530,-97.06265,2017
12/9/2016,La La Land,20000000,151101803,131101803,655.509015,2016
11/3/2017,LBJ,20000000,2468683,-17531317,-87.656585,2017
10/1/2010,Let Me In,20000000,12134935,-7865065,-39.325325,2010
4/24/2015,Little Boy,20000000,6485961,-13514039,-67.570195,2015
4/13/2012,Lockout,20000000,14326865,-5673135,-28.365675,2012
10/11/2013,Machete Kills,20000000,8008161,-11991839,-59.959195,2013
6/26/2015,Max,20000000,42656255,22656255,113.281275,2015
6/3/2016,Me Before You,20000000,56245075,36245075,181.225375,2016
8/6/2010,Middle Men,20000000,754301,-19245699,-96.228495,2010
7/1/2011,Monte Carlo,20000000,23186769,3186769,15.933845,2011
11/13/2015,My All-American,20000000,2246000,-17754000,-88.77,2015
7/27/2016,Nerve,20000000,38583626,18583626,92.91813,2016
12/25/2018,On the Basis of Sex,20000000,24622687,4622687,23.113435,2018
6/3/2016,Popstar: Never Stop Never Stopping,20000000,9496130,-10503870,-52.51935,2016
4/29/2016,Ratchet and Clank,20000000,8813410,-11186590,-55.93295,2016
10/30/2015,Regression,20000000,55039,-19944961,-99.724805,2015
2/19/2016,Risen,20000000,36880033,16880033,84.400165,2016
6/16/2017,Rough Night,20000000,22105643,2105643,10.528215,2017
4/12/2013,Scary Movie V,20000000,32015787,12015787,60.078935,2013
11/20/2015,Secret in Their Eyes,20000000,20180155,180155,0.900775,2015
1/9/2015,Selma,20000000,52076908,32076908,160.38454,2015
3/12/2010,She's Out of My League,20000000,32010860,12010860,60.0543,2010
10/26/2012,Silent Hill: Revelation 3D,20000000,17530219,-2469781,-12.348905,2012
11/6/2015,Spotlight,20000000,45055776,25055776,125.27888,2015
5/29/2015,Survivor,20000000,0,-20000000,-100,2015
10/26/2018,Suspiria,20000000,2483472,-17516528,-87.58264,2018
7/2/2014,Tammy,20000000,84525432,64525432,322.62716,2014
1/4/2013,Texas Chainsaw 3D,20000000,34341945,14341945,71.709725,2013
10/27/2017,Thank You for Your Service,20000000,9479390,-10520610,-52.60305,2017
9/1/2010,The American,20000000,35606376,15606376,78.03188,2010
9/7/2012,The Cold Light of Day,20000000,3763583,-16236417,-81.182085,2012
7/19/2013,The Conjuring,20000000,137400141,117400141,587.000705,2013
8/31/2011,The Debt,20000000,31177548,11177548,55.88774,2011
11/16/2011,The Descendants,20000000,82624961,62624961,313.124805,2011
11/18/2016,The History of Love,20000000,0,-20000000,-100,2016
3/31/2010,The Last Song,20000000,62950384,42950384,214.75192,2010
9/2/2016,The Light Between Oceans,20000000,12545979,-7454021,-37.270105,2016
8/29/2012,The Oogieloves in the BIG Balloon Adventure,20000000,1065907,-18934093,-94.670465,2012
11/17/2017,The Star,20000000,40847995,20847995,104.239975,2017
12/10/2010,The Tempest,20000000,277943,-19722057,-98.610285,2010
12/31/2017,The Thousand Miles,20000000,0,-20000000,-100,2017
8/23/2013,The World's End,20000000,26004851,6004851,30.024255,2013
3/31/2017,The Zookeeperâs Wife,20000000,17445186,-2554814,-12.77407,2017
9/19/2014,This is Where I Leave You,20000000,34296320,14296320,71.4816,2014
4/13/2010,Three Kingdoms: Resurrection of the Dragon,20000000,0,-20000000,-100,2010
2/26/2016,Triple 9,20000000,12639297,-7360703,-36.803515,2016
10/20/2017,Tyler Perryâs Boo 2! A Madea Halloween,20000000,47319572,27319572,136.59786,2017
10/21/2016,Tyler Perryâs Boo! A Madea Halloween,20000000,73206343,53206343,266.031715,2016
6/29/2012,Tyler Perry's Madea's Witness Protection,20000000,65653242,45653242,228.26621,2012
3/22/2019,Us,20000000,175006930,155006930,775.03465,2019
8/18/2010,Vampires Suck,20000000,36661504,16661504,83.30752,2010
2/8/2019,What Men Want,20000000,54611903,34611903,173.059515,2019
9/30/2011,What's Your Number?,20000000,14011084,-5988916,-29.94458,2011
4/2/2010,Why Did I Get Married Too?,20000000,60095852,40095852,200.47926,2010
11/17/2017,Wonder,20000000,132422809,112422809,562.114045,2017
9/24/2010,You Again,20000000,25702053,5702053,28.510265,2010
12/31/2012,Zambezia,20000000,0,-20000000,-100,2012
12/13/2018,Bird Box,19800000,0,-19800000,-100,2018
11/23/2012,De rouille et dâos,19500000,2061449,-17438551,-89.42846667,2012
12/1/2017,The Shape of Water,19500000,63859435,44359435,227.4842821,2017
8/23/2013,The Frozen Ground,19200000,0,-19200000,-100,2013
7/29/2011,The Devil's Double,19100000,1361512,-17738488,-92.87166492,2011
6/1/2018,Action Point,19000000,5059608,-13940392,-73.37048421,2018
6/24/2011,Bad Teacher,19000000,100292856,81292856,427.8571368,2011
12/13/2011,George Balanchine\'s The Nutcracker,19000000,2119994,-16880006,-88.84213684,2011
1/8/2010,Leap Year,19000000,25918920,6918920,36.41536842,2010
11/2/2018,Nobodyâs Fool,19000000,31713110,12713110,66.91110526,2018
3/8/2016,Out of the Inferno,19000000,0,-19000000,-100,2016
8/12/2016,Sausage Party,19000000,97670358,78670358,414.0545158,2016
3/4/2011,Take Me Home Tonight,19000000,6928068,-12071932,-63.53648421,2011
11/8/2013,The Book Thief,19000000,21488481,2488481,13.09726842,2013
2/26/2010,The Crazies,19000000,39123589,20123589,105.9136263,2010
8/20/2010,The Switch,19000000,27758465,8758465,46.09718421,2010
9/28/2012,Won't Back Down,19000000,5310554,-13689446,-72.04971579,2012
11/5/2010,127 Hours,18000000,18335230,335230,1.862388889,2010
7/25/2014,And So It Goes,18000000,15160801,-2839199,-15.77332778,2014
10/17/2014,Birdman or (The Unexpected Virtue of Ignorance),18000000,42340598,24340598,135.2255444,2014
7/26/2013,Blue Jasmine,18000000,33404871,15404871,85.58261667,2013
10/15/2010,Carlos,18000000,145526,-17854474,-99.19152222,2010
3/25/2011,Diary of a Wimpy Kid: Rodrick Rules,18000000,52698535,34698535,192.7696389,2011
2/19/2016,Forsaken,18000000,0,-18000000,-100,2016
8/30/2013,Getaway,18000000,10501938,-7498062,-41.6559,2013
4/15/2016,I Am Wrath,18000000,0,-18000000,-100,2016
8/16/2013,Jobs,18000000,16131410,-1868590,-10.38105556,2013
1/31/2014,Labor Day,18000000,13371528,-4628472,-25.71373333,2014
11/13/2015,Love the Coopers,18000000,26302731,8302731,46.12628333,2015
8/20/2010,Mao's Last Dancer,18000000,4806750,-13193250,-73.29583333,2010
9/27/2013,Metallica Through the Never,18000000,3419967,-14580033,-81.00018333,2013
3/18/2016,Midnight Special,18000000,3712282,-14287718,-79.37621111,2016
11/25/2016,Miss Sloane,18000000,3500605,-14499395,-80.55219444,2016
3/25/2016,My Big Fat Greek Wedding 2,18000000,59689605,41689605,231.6089167,2016
5/9/2014,Neighbors,18000000,150086800,132086800,733.8155556,2014
1/15/2016,Norm of the North,18000000,17062499,-937501,-5.208338889,2016
3/1/2013,Phantom,18000000,1034589,-16965411,-94.25228333,2013
8/7/2015,Ricki and the Flash,18000000,26839498,8839498,49.10832222,2015
4/8/2011,Soul Surfer,18000000,43853424,25853424,143.6301333,2011
3/17/2017,T2: Trainspotting,18000000,2402004,-15597996,-86.65553333,2017
4/28/2017,The Circle,18000000,20497844,2497844,13.87691111,2017
1/15/2010,The Last Station,18000000,6617867,-11382133,-63.23407222,2010
9/11/2015,The Perfect Guy,18000000,57027435,39027435,216.8190833,2015
8/22/2014,The Prince,18000000,0,-18000000,-100,2014
4/11/2014,The Railway Man,18000000,4438438,-13561562,-75.34201111,2014
6/29/2018,Uncle Drew,18000000,42469946,24469946,135.9441444,2018
11/14/2014,Wolves,18000000,0,-18000000,-100,2014
1/8/2010,Youth in Revolt,18000000,15285588,-2714412,-15.08006667,2010
7/13/2012,Red Lights,17700000,49521,-17650479,-99.72022034,2012
11/27/2013,Black Nativity,17500000,7018188,-10481812,-59.89606857,2013
4/6/2018,A Quiet Place,17000000,188024361,171024361,1006.025653,2018
11/11/2016,Almost Christmas,17000000,42065185,25065185,147.4422647,2016
3/4/2011,Beastly,17000000,27865571,10865571,63.91512353,2011
3/5/2010,Brooklyn's Finest,17000000,27163593,10163593,59.78584118,2010
7/12/2019,Crawl,17000000,0,-17000000,-100,2019
6/26/2015,Escobar: Paradise Lost,17000000,195792,-16804208,-98.84828235,2015
4/5/2013,Evil Dead,17000000,54239856,37239856,219.0579765,2013
6/10/2016,Genius,17000000,1361045,-15638955,-91.99385294,2016
8/13/2014,Letâs Be Cops,17000000,82390774,65390774,384.6516118,2014
12/25/2010,L'illusionniste,17000000,2231474,-14768526,-86.87368235,2010
8/20/2010,Lottery Ticket,17000000,24719879,7719879,45.41105294,2010
2/20/2015,"McFarland, USA",17000000,44480275,27480275,161.6486765,2015
9/26/2017,"Mune, le gardien de la lune",17000000,0,-17000000,-100,2017
9/28/2012,Pitch Perfect,17000000,65001093,48001093,282.3593706,2012
10/29/2010,Saw 3D,17000000,45710178,28710178,168.8834,2010
8/24/2012,The Apparition,17000000,4936819,-12063181,-70.95988824,2012
11/15/2013,The Best Man Holiday,17000000,70525195,53525195,314.8540882,2013
3/11/2016,The Young Messiah,16800000,6469813,-10330187,-61.48920833,2016
11/18/2016,Bleed for This,16000000,5083906,-10916094,-68.2255875,2016
9/24/2010,Enter the Void,16000000,337997,-15662003,-97.88751875,2010
3/9/2010,Hachiko: A Dog's Story,16000000,0,-16000000,-100,2010
5/11/2010,Haeundae,16000000,0,-16000000,-100,2010
10/3/2014,Left Behind,16000000,14019924,-1980076,-12.375475,2014
10/1/2014,"Men, Women and Children",16000000,705908,-15294092,-95.588075,2014
5/25/2012,Moonrise Kingdom,16000000,45512466,29512466,184.4529125,2012
6/29/2012,People Like Us,16000000,12431792,-3568208,-22.3013,2012
3/12/2010,Remember Me,16000000,19068240,3068240,19.1765,2010
6/13/2018,Superfly,16000000,20537137,4537137,28.35710625,2018
11/25/2011,The Artist,16000000,44667095,28667095,179.1693438,2011
11/14/2014,The Homesman,16000000,2429989,-13570011,-84.81256875,2014
5/16/2014,The Immigrant,16000000,2013456,-13986544,-87.4159,2014
2/4/2011,The Roommate,16000000,37300107,21300107,133.1256688,2011
4/5/2013,Trance,16000000,2322593,-13677407,-85.48379375,2013
11/2/2012,Vamps,16000000,3361,-15996639,-99.97899375,2012
12/31/2013,Zulu,16000000,0,-16000000,-100,2013
12/21/2018,Second Act,15700000,39282227,23582227,150.2052675,2018
2/26/2010,The Yellow Handkerchief,15500000,318623,-15181377,-97.94436774,2010
5/5/2015,A Few Best Men,15000000,0,-15000000,-100,2015
7/25/2014,A Most Wanted Man,15000000,17237855,2237855,14.91903333,2014
8/11/2017,Annabelle: Creation,15000000,102092201,87092201,580.6146733,2017
10/10/2014,AutÃ³mata,15000000,0,-15000000,-100,2014
8/10/2018,BlacKkKlansman,15000000,49275340,34275340,228.5022667,2018
8/14/2019,Blinded by the Light,15000000,0,-15000000,-100,2019
9/1/2015,Broken Horses,15000000,0,-15000000,-100,2015
10/16/2015,CÃ¬kÃ¨ NiÃ¨ YinniÃ¡ng,15000000,632542,-14367458,-95.78305333,2015
8/27/2010,Centurion,15000000,123570,-14876430,-99.1762,2010
12/31/2015,Chiamatemi Francesco - Il papa della gente,15000000,0,-15000000,-100,2015
12/22/2010,Country Strong,15000000,20218921,5218921,34.79280667,2010
3/19/2010,Diary of a Wimpy Kid,15000000,64003625,49003625,326.6908333,2010
9/16/2011,Drive,15000000,35060689,20060689,133.7379267,2011
9/21/2012,End of Watch,15000000,41003371,26003371,173.3558067,2012
9/8/2017,Home Again,15000000,27020284,12020284,80.13522667,2017
6/8/2018,Hotel Artemis,15000000,6708137,-8291863,-55.27908667,2018
2/17/2017,In Dubious Battle,15000000,0,-15000000,-100,2017
10/25/2013,Jackass Presents: Bad Grandpa,15000000,102003019,87003019,580.0201267,2013
4/29/2016,Keanu,15000000,20591853,5591853,37.27902,2016
12/6/2013,Khumba,15000000,0,-15000000,-100,2013
11/30/2012,Killing Them Softly,15000000,14945541,-54459,-0.36306,2012
12/4/2015,Krampus,15000000,42725475,27725475,184.8365,2015
1/18/2013,Mama,15000000,71628180,56628180,377.5212,2013
2/1/2019,Miss Bala,15000000,14998027,-1973,-0.013153333,2019
9/15/2010,Never Let Me Go,15000000,2434652,-12565348,-83.76898667,2010
8/19/2011,One Day,15000000,13843771,-1156229,-7.708193333,2011
1/4/2013,Promised Land,15000000,7597898,-7402102,-49.34734667,2013
9/23/2016,Queen of Katwe,15000000,8874389,-6125611,-40.83740667,2016
7/23/2010,Ramona and Beezus,15000000,26167002,11167002,74.44668,2010
10/23/2015,Rock the Kasbah,15000000,3020665,-11979335,-79.86223333,2015
2/5/2010,San suk si gin,15000000,0,-15000000,-100,2010
10/30/2015,Scouts Guide to the Zombie Apocalypse,15000000,3703046,-11296954,-75.31302667,2015
2/22/2013,Snitch,15000000,42930462,27930462,186.20308,2013
2/3/2017,The Comedian,15000000,1658706,-13341294,-88.94196,2017
9/9/2016,The Disappointments Room,15000000,2423467,-12576533,-83.84355333,2016
11/23/2018,The Favourite,15000000,34366783,19366783,129.1118867,2018
1/20/2017,The Founder,15000000,12786053,-2213947,-14.75964667,2017
11/28/2014,The Imitation Game,15000000,91125143,76125143,507.5009533,2014
11/26/2010,The King's Speech,15000000,138797449,123797449,825.3163267,2010
11/2/2012,The Man with the Iron Fists,15000000,15634090,634090,4.227266667,2012
8/27/2014,The November Man,15000000,25018119,10018119,66.78746,2014
3/29/2013,The Place Beyond the Pines,15000000,21403519,6403519,42.69012667,2013
4/26/2013,The Reluctant Fundamentalist,15000000,528731,-14471269,-96.47512667,2013
11/4/2011,The Son of No One,15000000,30680,-14969320,-99.79546667,2011
11/7/2014,The Theory of Everything,15000000,35893537,20893537,139.2902467,2014
2/3/2012,The Woman in Black,15000000,54333290,39333290,262.2219333,2012
8/22/2014,When the Game Stands Tall,15000000,30127963,15127963,100.8530867,2014
12/3/2014,Wild,15000000,37880356,22880356,152.5357067,2014
9/6/2013,Winnie Mandela,15000000,61847,-14938153,-99.58768667,2013
9/22/2010,You Will Meet a Tall Dark Stranger,15000000,3247816,-11752184,-78.34789333,2010
7/22/2011,Elle s'appelait Sarah,14500000,7691700,-6808300,-46.9537931,2011
6/5/2015,Freedom,14500000,0,-14500000,-100,2015
7/1/2015,Magic Mike XXL,14500000,66013057,51513057,355.2624621,2015
8/6/2010,Flipped,14000000,1755212,-12244788,-87.46277143,2010
10/26/2012,Fun Size,14000000,9409538,-4590462,-32.78901429,2012
2/20/2015,Hot Tub Time Machine 2,14000000,12314651,-1685349,-12.03820714,2015
6/25/2010,Les herbes folles,14000000,403952,-13596048,-97.11462857,2010
9/30/2011,Margaret,14000000,47185,-13952815,-99.66296429,2011
12/19/2014,Mr. Turner,14000000,3958546,-10041454,-71.72467143,2014
3/12/2010,Our Family Wedding,14000000,20255281,6255281,44.68057857,2010
11/1/2016,Reign of Assassins,14000000,0,-14000000,-100,2016
10/23/2015,Suffragette,14000000,4702420,-9297580,-66.41128571,2015
1/13/2012,The Iron Lady,14000000,29959436,15959436,113.9959714,2012
8/31/2012,The Possession,14000000,49130588,35130588,250.9327714,2012
2/24/2012,Tyler Perry's Good Deeds,14000000,35025791,21025791,150.1842214,2012
10/12/2012,Seven Psychopaths,13500000,15024049,1524049,11.28925185,2012
4/1/2011,The Last Godfather,13400000,164247,-13235753,-98.77427612,2011
4/4/2014,Under the Skin,13300000,2614251,-10685749,-80.34397744,2014
9/12/2014,No Good Deed,13200000,52543632,39343632,298.0578182,2014
3/1/2013,21 and Over,13000000,25682380,12682380,97.55676923,2013
2/14/2014,About Last Night,13000000,48637684,35637684,274.1360308,2014
3/22/2013,Admission,13000000,18007317,5007317,38.51782308,2013
7/29/2011,Attack the Block,13000000,1024175,-11975825,-92.12173077,2011
7/17/2015,Bajrangi Bhaijaan,13000000,8178001,-4821999,-37.0923,2015
12/7/2018,Ben is Back,13000000,3703182,-9296818,-71.51398462,2018
12/3/2010,Black Swan,13000000,106954678,93954678,722.7282923,2010
8/14/2015,Brothers,13000000,656688,-12343312,-94.94855385,2015
3/26/2010,Chloe,13000000,3075255,-9924745,-76.34419231,2010
7/2/2014,Earth to Echo,13000000,38934842,25934842,199.4987846,2014
4/10/2015,Ex Machina,13000000,25440971,12440971,95.69977692,2015
3/11/2016,Eye in the Sky,13000000,18704596,5704596,43.88150769,2016
12/3/2010,"I Love You, Phillip Morris",13000000,2037459,-10962541,-84.32723846,2010
12/23/2011,In The Land of Blood and Honey,13000000,303877,-12696123,-97.66248462,2011
2/11/2011,Justin Bieber: Never Say Never,13000000,73013910,60013910,461.6454615,2011
3/16/2016,Miracles from Heaven,13000000,61705123,48705123,374.6547923,2016
9/9/2016,Robinson Crusoe,13000000,8005586,-4994414,-38.41856923,2016
12/31/2019,Rogue City,13000000,0,-13000000,-100,2019
10/16/2015,Room,13000000,14677674,1677674,12.90518462,2015
10/10/2014,St. Vincent,13000000,44137712,31137712,239.5208615,2014
7/4/2018,The First Purge,13000000,69488745,56488745,434.5288077,2018
6/18/2010,The Killer Inside Me,13000000,217277,-12782723,-98.32863846,2010
9/21/2012,The Perks of Being a Wallflower,13000000,17742948,4742948,36.48421538,2012
6/24/2016,The Shallows,13000000,55121623,42121623,324.0124846,2016
7/24/2015,The Vatican Tapes,13000000,1784763,-11215237,-86.27105385,2015
2/26/2010,Un ProphÃ¨te,13000000,2087720,-10912280,-83.94061538,2010
3/30/2012,Womb,13000000,0,-13000000,-100,2012
10/16/2015,Woodlawn,13000000,14394097,1394097,10.72382308,2015
12/4/2015,Youth,13000000,2703296,-10296704,-79.20541538,2015
3/15/2013,The Call,12800000,51872378,39072378,305.2529531,2013
8/5/2016,Operation Chromite,12700000,1022720,-11677280,-91.94708661,2016
9/12/2014,The Drop,12600000,10724389,-1875611,-14.88580159,2014
5/4/2012,A Little Bit of Heaven,12500000,10011,-12489989,-99.919912,2012
12/17/2010,Casino Jack,12500000,2039869,-10460131,-83.681048,2010
10/15/2010,Conviction,12500000,6797696,-5702304,-45.618432,2010
3/1/2013,Ernest et Celestine,12500000,292562,-12207438,-97.659504,2013
9/3/2010,Machete,12500000,26593646,14093646,112.749168,2010
5/21/2010,Solitary Man,12500000,4360548,-8139452,-65.115616,2010
10/5/2012,The Paperboy,12500000,677200,-11822800,-94.5824,2012
4/16/2010,The Perfect Game,12500000,1089445,-11410555,-91.28444,2010
11/11/2015,10 Days in a Madhouse,12000000,14616,-11985384,-99.8782,2015
8/19/2011,5 Days of War,12000000,17479,-11982521,-99.85434167,2011
11/1/2013,About Time,12000000,15323921,3323921,27.69934167,2013
2/24/2012,Act of Valor,12000000,70012847,58012847,483.4403917,2012
9/14/2012,Arbitrage,12000000,7919574,-4080426,-34.00355,2012
2/3/2012,Chronicle,12000000,64575175,52575175,438.1264583,2012
10/30/2015,Dancin' It's On,12000000,0,-12000000,-100,2015
4/20/2012,Darling Companion,12000000,793352,-11206648,-93.38873333,2012
10/3/2014,Drive Hard,12000000,0,-12000000,-100,2014
6/1/2012,For Greater Glory: The True Story of Cristiada,12000000,5669081,-6330919,-52.75765833,2012
4/16/2014,Heaven is for Real,12000000,91386097,79386097,661.5508083,2014
8/12/2016,Hell or High Water,12000000,27007844,15007844,125.0653667,2016
12/14/2018,If Beale Street Could Talk,12000000,14915773,2915773,24.29810833,2018
5/14/2010,Just Wright,12000000,21540363,9540363,79.503025,2010
7/5/2012,Katy Perry: Part of Me,12000000,25326071,13326071,111.0505917,2012
3/11/2011,Kill the Irishman,12000000,1188194,-10811806,-90.09838333,2011
11/15/2013,La grande bellezza,12000000,2883879,-9116121,-75.967675,2013
11/25/2016,Lion,12000000,51739495,39739495,331.1624583,2016
10/13/2017,Marshall,12000000,10051659,-1948341,-16.236175,2017
11/15/2013,Nebraska,12000000,17654912,5654912,47.12426667,2013
6/4/2010,Ondine,12000000,550472,-11449528,-95.41273333,2010
5/4/2018,Overboard,12000000,50316123,38316123,319.301025,2018
7/24/2015,Paper Towns,12000000,32000304,20000304,166.6692,2015
11/22/2013,Philomena,12000000,37709979,25709979,214.249825,2013
1/30/2015,Project Almanac,12000000,22348241,10348241,86.23534167,2015
3/2/2012,Project X,12000000,54731865,42731865,356.098875,2012
12/31/2015,San cheng ji,12000000,0,-12000000,-100,2015
9/3/2010,San qiang pai an jing qi,12000000,190946,-11809054,-98.40878333,2010
3/1/2013,Stoker,12000000,1703125,-10296875,-85.80729167,2013
10/19/2013,Supesu Batorushippu Yamato,12000000,0,-12000000,-100,2013
6/6/2014,The Fault in Our Stars,12000000,124872350,112872350,940.6029167,2014
4/20/2012,Think Like a Man,12000000,91547205,79547205,662.893375,2012
11/10/2017,"Three Billboards Outside Ebbing, Missouri",12000000,54513740,42513740,354.2811667,2017
12/12/2014,Top Five,12000000,25317379,13317379,110.9781583,2014
10/9/2015,Trash,12000000,17484,-11982516,-99.8543,2015
2/10/2010,Triangle,12000000,0,-12000000,-100,2010
12/31/2011,Tu Xia Chuan Qi,12000000,0,-12000000,-100,2011
4/21/2017,Unforgettable,12000000,11368012,-631988,-5.266566667,2017
7/14/2017,Wish Upon,12000000,14301505,2301505,19.17920833,2017
12/9/2011,Young Adult,12000000,16311571,4311571,35.92975833,2011
9/23/2016,The Dressmaker,11900000,2022115,-9877885,-83.00743697,2016
11/20/2015,Carol,11800000,12711491,911491,7.7245,2015
1/22/2016,Dirty Grandpa,11500000,35593113,24093113,209.5053304,2016
8/26/2011,Brighton Rock,11000000,229653,-10770347,-97.91224545,2011
11/4/2015,Brooklyn,11000000,38322743,27322743,248.3885727,2015
12/31/2019,Eli,11000000,0,-11000000,-100,2019
2/14/2019,Fighting With My Family,11000000,22958583,11958583,108.7143909,2019
12/8/2017,"I, Tonya",11000000,30014534,19014534,172.8594,2017
8/22/2014,If I Stay,11000000,50474843,39474843,358.8622091,2014
12/6/2013,Inside Llewyn Davis,11000000,13248209,2248209,20.43826364,2013
5/8/2015,La famille BÃ©lier,11000000,0,-11000000,-100,2015
11/16/2012,Le prÃ©nom,11000000,61611,-10938389,-99.4399,2012
5/4/2012,LOL,11000000,0,-11000000,-100,2012
2/5/2016,Misconduct,11000000,0,-11000000,-100,2016
5/10/2013,Peeples,11000000,9177065,-1822935,-16.57213636,2013
1/11/2013,Quartet,11000000,18388357,7388357,67.16688182,2013
7/6/2016,Sultan,11000000,5599781,-5400219,-49.0929,2016
12/10/2010,The Fighter,11000000,93617009,82617009,751.0637182,2010
4/1/2015,Woman in Gold,11000000,33307793,22307793,202.7981182,2015
5/25/2012,Les Intouchables,10800000,13182281,2382281,22.05815741,2012
12/6/2013,The Last Days on Mars,10600000,24084,-10575916,-99.77279245,2013
1/4/2019,PMC: deo beong-keo,10300000,0,-10300000,-100,2019
4/30/2010,Housefull,10100000,1183658,-8916342,-88.28061386,2010
3/21/2014,50 to 1,10000000,1069454,-8930546,-89.30546,2014
6/24/2011,A Better Life,10000000,1759252,-8240748,-82.40748,2011
7/21/2015,American Heist,10000000,0,-10000000,-100,2015
10/12/2012,Atlas Shrugged: Part II,10000000,3336053,-6663947,-66.63947,2012
3/14/2014,Bad Words,10000000,7779614,-2220386,-22.20386,2014
12/26/2014,Barbecue,10000000,388,-9999612,-99.99612,2014
12/25/2014,Big Eyes,10000000,14482031,4482031,44.82031,2014
9/16/2016,Blair Witch,10000000,20777061,10777061,107.77061,2016
2/19/2010,Blood Done Sign My Name,10000000,109383,-9890617,-98.90617,2010
5/18/2018,Book Club,10000000,68566296,58566296,585.66296,2018
9/9/2011,Bucky Larson: Born to Be a Star,10000000,2529395,-7470605,-74.70605,2011
10/19/2018,Can You Ever Forgive Me?,10000000,8803865,-1196135,-11.96135,2018
2/11/2011,Cedar Rapids,10000000,6861102,-3138898,-31.38898,2011
6/2/2017,Churchill,10000000,1279681,-8720319,-87.20319,2017
5/3/2013,"Cinco de Mayo, La Batalla",10000000,173472,-9826528,-98.26528,2013
1/20/2012,Coriolanus,10000000,749641,-9250359,-92.50359,2012
3/20/2015,Danny Collins,10000000,5637066,-4362934,-43.62934,2015
9/30/2016,Denial,10000000,4073448,-5926552,-59.26552,2016
4/13/2012,Detention,10000000,0,-10000000,-100,2012
9/17/2010,Devil,10000000,33679655,23679655,236.79655,2010
8/26/2016,Don't Breathe,10000000,89217875,79217875,792.17875,2016
11/7/2014,Elsa & Fred,10000000,67657,-9932343,-99.32343,2014
3/30/2016,Everybody Wants Some,10000000,3400278,-6599722,-65.99722,2016
5/19/2017,"Everything, Everything",10000000,34121140,24121140,241.2114,2017
4/21/2017,Free Fire,10000000,1799322,-8200678,-82.00678,2017
6/15/2018,Gotti,10000000,4286367,-5713633,-57.13633,2018
10/19/2018,Halloween,10000000,159342015,149342015,1493.42015,2018
6/8/2018,Hereditary,10000000,44069456,34069456,340.69456,2018
6/1/2012,High School,10000000,139034,-9860966,-98.60966,2012
4/28/2017,How to Be a Latin Lover,10000000,32149404,22149404,221.49404,2017
3/13/2015,Hross i oss,10000000,11894,-9988106,-99.88106,2015
6/5/2015,Insidious Chapter 3,10000000,52218558,42218558,422.18558,2015
1/5/2018,Insidious: The Last Key,10000000,67745330,57745330,577.4533,2018
5/19/2015,Into the Grizzly Maze,10000000,0,-10000000,-100,2015
6/18/2010,Io sono lâamore,10000000,5005465,-4994535,-49.94535,2010
10/8/2010,It's a Wonderful Afterlife,10000000,0,-10000000,-100,2010
3/16/2012,"Jeff, Who Lives at Home",10000000,4269426,-5730574,-57.30574,2012
10/27/2017,Jigsaw,10000000,38052832,28052832,280.52832,2017
4/23/2010,Joheunnom nabbeunnom isanghannom,10000000,128486,-9871514,-98.71514,2010
3/10/2015,Jungle Shuffle,10000000,0,-10000000,-100,2015
10/14/2016,Kevin Hart: What Now?,10000000,23591043,13591043,135.91043,2016
9/9/2016,Kicks,10000000,150191,-9849809,-98.49809,2016
7/27/2012,Killer Joe,10000000,1291645,-8708355,-87.08355,2012
11/3/2017,Lady Bird,10000000,48958273,38958273,389.58273,2017
3/16/2018,"Love, Simon",10000000,40826341,30826341,308.26341,2018
5/21/2010,MacGruber,10000000,8525600,-1474400,-14.744,2010
10/14/2016,Max Steel,10000000,3818664,-6181336,-61.81336,2016
1/25/2013,Movie 43,10000000,8840453,-1159547,-11.59547,2013
4/26/2013,Mud,10000000,21590086,11590086,115.90086,2013
11/23/2011,My Week with Marilyn,10000000,14597405,4597405,45.97405,2011
2/7/2014,Nurse 3D,10000000,0,-10000000,-100,2014
8/30/2013,One Direction: This is Us,10000000,28873374,18873374,188.73374,2013
10/23/2015,Paranormal Activity: The Ghost Dimension,10000000,18297124,8297124,82.97124,2015
10/4/2013,Parkland,10000000,641439,-9358561,-93.58561,2013
9/26/2014,Plastic,10000000,0,-10000000,-100,2014
11/14/2014,Rosewater,10000000,3128941,-6871059,-68.71059,2014
6/22/2012,Seeking a Friend for the End of the World,10000000,7078738,-2921262,-29.21262,2012
11/11/2016,Shut In,10000000,6900335,-3099665,-30.99665,2016
8/21/2015,Sinister 2,10000000,27740955,17740955,177.40955,2015
11/12/2010,Skyline,10000000,21416355,11416355,114.16355,2010
8/10/2018,Slender Man,10000000,30564825,20564825,205.64825,2018
8/17/2012,Sparkle,10000000,24397469,14397469,143.97469,2012
7/10/2015,Strangerland,10000000,17472,-9982528,-99.82528,2015
7/27/2018,Teen Titans Go! To The Movies,10000000,29790236,19790236,197.90236,2018
6/5/2015,Testament of Youth,10000000,1822250,-8177750,-81.7775,2015
5/4/2012,The Best Exotic Marigold Hotel,10000000,46383639,36383639,363.83639,2012
4/5/2019,The Best of Enemies,10000000,10205616,205616,2.05616,2019
10/7/2016,The Birth of a Nation,10000000,15861566,5861566,58.61566,2016
1/22/2016,The Boy,10000000,35819556,25819556,258.19556,2016
11/30/2012,The Collection,10000000,6810754,-3189246,-31.89246,2012
12/1/2017,The Disaster Artist,10000000,21120616,11120616,111.20616,2017
1/8/2016,The Forest,10000000,26594261,16594261,165.94261,2016
2/19/2010,The Good Guy,10000000,100688,-9899312,-98.99312,2010
5/3/2013,The Iceman,10000000,1930282,-8069718,-80.69718,2013
4/16/2010,The Joneses,10000000,1475746,-8524254,-85.24254,2010
4/29/2016,The Man Who Knew Infinity,10000000,3877922,-6122078,-61.22078,2016
8/6/2010,The Oxford Murders,10000000,4803,-9995197,-99.95197,2010
7/1/2016,The Purge: Election Year,10000000,79042440,69042440,690.4244,2016
12/31/2010,The Reef,10000000,0,-10000000,-100,2010
3/6/2015,The Second Best Exotic Marigold Hotel,10000000,33078266,23078266,230.78266,2015
10/29/2010,Welcome to the Rileys,10000000,152857,-9847143,-98.47143,2010
9/9/2016,When the Bough Breaks,10000000,29747603,19747603,197.47603,2016
3/27/2015,While We're Young,10000000,7582065,-2417935,-24.17935,2015
6/21/2011,You Got Served: Beat The World,10000000,0,-10000000,-100,2011
9/22/2017,Friend Request,9900000,3759078,-6140922,-62.02951515,2017
4/30/2010,Gunless,9900000,458054,-9441946,-95.37319192,2010
12/19/2012,Amour,9700000,6738954,-2961046,-30.52624742,2012
12/21/2016,Dangal,9500000,12391761,2891761,30.43958947,2016
12/31/2013,Re-Kill,9500000,0,-9500000,-100,2013
3/19/2010,The Runaways,9500000,3573673,-5926327,-62.38238947,2010
11/11/2011,Melancholia,9400000,3030848,-6369152,-67.75693617,2011
11/13/2012,Jab Tak Hai Jaan,9200000,3047539,-6152461,-66.87457609,2012
5/21/2010,Kites,9200000,1685269,-7514731,-81.6818587,2010
12/31/2010,Mine Vaganti,9100000,0,-9100000,-100,2010
12/31/2011,Red Dog,9100000,0,-9100000,-100,2011
2/1/2013,A Haunting in Connecticut 2: The Ghosts of Georgia,9000000,0,-9000000,-100,2013
6/17/2014,Beneath Hill 60,9000000,0,-9000000,-100,2014
1/30/2015,Black or White,9000000,21571189,12571189,139.6798778,2015
12/25/2018,Destroyer,9000000,1533324,-7466676,-82.96306667,2018
5/6/2016,Dheepan,9000000,248795,-8751205,-97.23561111,2016
8/12/2011,Glee: The 3D Concert Movie,9000000,11862398,2862398,31.80442222,2011
8/26/2016,Greater,9000000,2000093,-6999907,-77.77674444,2016
2/13/2019,Happy Death Day 2U,9000000,28051045,19051045,211.6782778,2019
12/2/2016,Jackie,9000000,13960394,4960394,55.11548889,2016
1/22/2010,La fille du RER,9000000,208163,-8791837,-97.68707778,2010
4/2/2010,Leaves of Grass,9000000,70066,-8929934,-99.22148889,2010
11/4/2016,Loving,9000000,7710234,-1289766,-14.33073333,2016
10/21/2016,Ouija: Origin of Evil,9000000,35144505,26144505,290.4945,2016
5/14/2010,Princess Kaiulani,9000000,883887,-8116113,-90.17903333,2010
2/5/2010,Red Riding: The Year of Our Lord 1974,9000000,148826,-8851174,-98.34637778,2010
5/8/2015,Skin Trade,9000000,1242,-8998758,-99.9862,2015
11/18/2016,The Edge of Seventeen,9000000,14431633,5431633,60.35147778,2016
7/18/2014,The Purge: Anarchy,9000000,71562550,62562550,695.1394444,2014
3/22/2013,The Sapphires,9000000,2450867,-6549133,-72.76814444,2013
5/17/2019,The Sun is Also a Star,9000000,4950029,-4049971,-44.99967778,2019
1/20/2015,Veronika Decides to Die,9000000,0,-9000000,-100,2015
11/13/2015,Heist,8900000,50136,-8849864,-99.43667416,2015
5/18/2012,Polisse,8900000,176988,-8723012,-98.01137079,2012
2/26/2011,Ultramarines,8900000,0,-8900000,-100,2011
11/1/2016,A.C.O.R.N.S.: Operation Crackdown,8500000,0,-8500000,-100,2016
10/18/2013,All is Lost,8500000,6263670,-2236330,-26.30976471,2013
9/27/2013,Baggage Claim,8500000,21569509,13069509,153.7589294,2013
1/16/2019,Dragon Ball Super: Broly,8500000,30376755,21876755,257.3735882,2019
11/18/2016,Manchester by the Sea,8500000,47695371,39195371,461.1220118,2016
10/7/2016,Middle School: The Worst Years of My Life,8500000,20007149,11507149,135.3782235,2016
10/31/2014,Nightcrawler,8500000,32381218,23881218,280.9555059,2014
12/31/2017,Posledniy bogatyr,8500000,0,-8500000,-100,2017
2/20/2015,The DUFF,8500000,34030343,25530343,300.3569765,2015
6/13/2014,The Rover,8500000,1109199,-7390801,-86.9506,2014
2/12/2010,My Name is Khan,8470000,4046336,-4423664,-52.22743802,2010
4/16/2010,The City of Your Final Destination,8300000,493296,-7806704,-94.0566747,2010
5/31/2013,Yeh Jawaani Hai Deewani,8300000,3827466,-4472534,-53.88595181,2013
9/30/2011,50/50,8000000,35016118,27016118,337.701475,2011
11/18/2016,A Street Cat Named Bob,8000000,82703,-7917297,-98.9662125,2016
9/2/2015,A Walk in the Woods,8000000,29499394,21499394,268.742425,2015
5/22/2015,Aloft,8000000,53086,-7946914,-99.336425,2015
12/30/2015,Anomalisa,8000000,3759286,-4240714,-53.008925,2015
12/29/2010,Another Year,8000000,3205706,-4794294,-59.928675,2010
4/24/2018,Backstabbing For Beginners,8000000,0,-8000000,-100,2018
6/27/2014,Begin Again,8000000,16170632,8170632,102.1329,2014
6/21/2019,Burn Your Maps,8000000,0,-8000000,-100,2019
5/6/2016,Code of Honor,8000000,0,-8000000,-100,2016
9/29/2017,"Don Gato, el inicio de la pandilla",8000000,0,-8000000,-100,2017
9/17/2010,Easy A,8000000,58401464,50401464,630.0183,2010
5/3/2019,El Chicano,8000000,700261,-7299739,-91.2467375,2019
9/18/2013,Enough Said,8000000,17550872,9550872,119.3859,2013
9/20/2013,Feichang Xingyun,8000000,0,-8000000,-100,2013
10/14/2011,Fireflies in the Garden,8000000,36884,-7963116,-99.53895,2011
2/24/2015,Green Street Hooligans: Underground,8000000,0,-8000000,-100,2015
12/31/2015,Henry Joseph Church,8000000,0,-8000000,-100,2015
10/8/2010,It's Kind of a Funny Story,8000000,6363628,-1636372,-20.45465,2010
12/20/2013,Le passÃ©,8000000,1335672,-6664328,-83.3041,2013
4/6/2018,Lean on Pete,8000000,1163056,-6836944,-85.4618,2018
10/26/2018,London Fields,8000000,252676,-7747324,-96.84155,2018
11/19/2010,Made in Dagenham,8000000,1095369,-6904631,-86.3078875,2010
6/12/2015,Me and Earl and the Dying Girl,8000000,6758416,-1241584,-15.5198,2015
9/2/2016,Morgan,8000000,3915251,-4084749,-51.0593625,2016
4/29/2011,Prom,8000000,10130219,2130219,26.6277375,2011
9/16/2011,Restless,8000000,163753,-7836247,-97.9530875,2011
8/12/2014,Swelter,8000000,0,-8000000,-100,2014
1/31/2014,That Awkward Moment,8000000,26068955,18068955,225.8619375,2014
5/3/2019,The Intruder,8000000,35095904,27095904,338.6988,2019
3/5/2010,The Secret of Kells,8000000,690290,-7309710,-91.371375,2010
10/29/2010,Wild Target,8000000,109338,-7890662,-98.633275,2010
10/5/2012,Wuthering Heights,8000000,100915,-7899085,-98.7385625,2012
4/14/2015,Loin des hommes,7700000,5336,-7694664,-99.9307013,2015
12/21/2011,Albert Nobbs,7500000,3014696,-4485304,-59.80405333,2011
1/9/2015,Black November,7500000,0,-7500000,-100,2015
4/13/2018,Borg vs McEnroe,7500000,231346,-7268654,-96.91538667,2018
2/24/2015,Outside Bet,7500000,0,-7500000,-100,2015
5/15/2015,Pound of Flesh,7500000,0,-7500000,-100,2015
6/24/2016,The Neon Demon,7500000,1333124,-6166876,-82.22501333,2016
1/13/2017,The Bye Bye Man,7400000,22395806,14995806,202.646027,2017
4/30/2010,Harry Brown,7300000,1818681,-5481319,-75.08656164,2010
5/27/2011,Die Welle,7250000,0,-7250000,-100,2011
9/16/2011,3,7200000,59774,-7140226,-99.16980556,2011
9/1/2015,Alpha & Omega: The Legend of the Saw Tooth Cave,7000000,0,-7000000,-100,2015
11/14/2014,Beyond the Lights,7000000,14618727,7618727,108.8389571,2014
5/24/2019,BrightBurn,7000000,16794432,9794432,139.9204571,2019
3/26/2010,Ca$h,7000000,46488,-6953512,-99.33588571,2010
11/20/2015,Criminal Activities,7000000,0,-7000000,-100,2015
6/18/2010,Cyrus,7000000,7468936,468936,6.699085714,2010
1/17/2014,Devil's Due,7000000,15821461,8821461,126.0208714,2014
4/2/2014,Dom Hemingway,7000000,523511,-6476489,-92.52127143,2014
6/19/2015,Dope,7000000,17506470,10506470,150.0924286,2015
3/15/2019,Five Feet Apart,7000000,45729221,38729221,553.2745857,2019
10/2/2015,Freeheld,7000000,546201,-6453799,-92.19712857,2015
12/31/2015,Geroy,7000000,0,-7000000,-100,2015
7/30/2010,Get Low,7000000,9176933,2176933,31.09904286,2010
4/7/2017,Gifted,7000000,24801212,17801212,254.3030286,2017
5/13/2011,Hesher,7000000,382946,-6617054,-94.52934286,2011
3/16/2018,I Can Only Imagine,7000000,83482352,76482352,1092.605029,2018
5/6/2011,Jumping the Broom,7000000,37295394,30295394,432.7913429,2011
6/29/2012,Magic Mike,7000000,113721571,106721571,1524.593871,2012
5/7/2010,Mother and Child,7000000,1110509,-5889491,-84.13558571,2010
12/6/2016,Oddball,7000000,0,-7000000,-100,2016
1/28/2014,Snezhnaya koroleva,7000000,0,-7000000,-100,2014
12/22/2010,Somewhere,7000000,1785645,-5214355,-74.49078571,2010
11/15/2013,The Christmas Candle,7000000,1632000,-5368000,-76.68571429,2013
7/30/2010,The Extra Man,7000000,453377,-6546623,-93.52318571,2010
10/21/2011,The Mighty Macs,7000000,1891936,-5108064,-72.97234286,2011
1/30/2015,Trudno byt bogom,7000000,31443,-6968557,-99.55081429,2015
7/23/2013,Twixt,7000000,0,-7000000,-100,2013
1/13/2012,We Need to Talk About Kevin,7000000,1738692,-5261308,-75.16154286,2012
8/18/2015,Z Storm,7000000,0,-7000000,-100,2015
9/21/2012,House at the End of the Street,6900000,31611916,24711916,358.1437101,2012
1/31/2017,Two Lovers and a Bear,6840000,0,-6840000,-100,2017
9/17/2010,Incendies,6800000,6857096,57096,0.839647059,2010
9/10/2010,Bran Nue Dae,6750000,113568,-6636432,-98.31751111,2010
5/21/2010,Perrierâs Bounty,6600000,828,-6599172,-99.98745455,2010
10/3/2014,Annabelle,6500000,84273813,77773813,1196.5202,2014
10/20/2017,Same Kind of Different as Me,6500000,6423605,-76395,-1.175307692,2017
12/2/2011,Shame,6500000,4002293,-2497707,-38.42626154,2011
5/31/2013,The East,6500000,2274649,-4225351,-65.0054,2013
12/31/2011,Tracker,6500000,0,-6500000,-100,2011
3/15/2011,A Shine of Rainbows,6000000,0,-6000000,-100,2011
3/4/2011,Akmareul Boatda,6000000,129210,-5870790,-97.8465,2011
4/27/2012,Bernie,6000000,9204489,3204489,53.40815,2012
5/11/2018,Breaking In,6000000,46840590,40840590,680.6765,2018
3/16/2012,Casa de mi Padre,6000000,5909483,-90517,-1.508616667,2012
3/19/2010,City Island,6000000,6671283,671283,11.18805,2010
12/7/2012,Deadfall,6000000,66351,-5933649,-98.89415,2012
4/2/2010,Don McKay,6000000,13722,-5986278,-99.7713,2010
12/31/2011,Freaky Deaky,6000000,0,-6000000,-100,2011
2/9/2010,Icarus,6000000,0,-6000000,-100,2010
4/29/2011,JÃ»san-nin no shikaku,6000000,802778,-5197222,-86.62036667,2011
9/14/2018,Mandy,6000000,1214525,-4785475,-79.75791667,2018
7/15/2011,Snow Flower and the Secret Fan,6000000,1348205,-4651795,-77.52991667,2011
1/23/2015,Song One,6000000,32251,-5967749,-99.46248333,2015
3/25/2011,The 5th Quarter,6000000,408159,-5591841,-93.19735,2011
4/2/2010,The Greatest,6000000,115862,-5884138,-98.06896667,2010
7/29/2011,The Guard,6000000,5359774,-640226,-10.67043333,2011
5/10/2011,The Hit List,6000000,0,-6000000,-100,2011
1/15/2016,The Lady in the Van,6000000,10021175,4021175,67.01958333,2016
11/30/2018,The Possession of Hannah Grace,6000000,14836174,8836174,147.2695667,2018
2/8/2019,The Prodigy,6000000,14856291,8856291,147.60485,2019
9/7/2012,The Words,6000000,11494838,5494838,91.58063333,2012
3/29/2019,Unplanned,6000000,18107621,12107621,201.7936833,2019
3/14/2014,Veronica Mars,6000000,3322127,-2677873,-44.63121667,2014
7/18/2014,Wish I Was Here,6000000,3591299,-2408701,-40.14501667,2014
10/5/2012,Trade of Innocents,5800000,15091,-5784909,-99.73981034,2012
3/18/2011,Winter in Wartime,5800000,542860,-5257140,-90.64034483,2011
9/7/2012,The Inbetweeners,5700000,35955,-5664045,-99.36921053,2012
7/16/2010,Valhalla Rising,5700000,30638,-5669362,-99.46249123,2010
7/9/2010,[Rec] 2,5600000,27766,-5572234,-99.50417857,2010
12/7/2012,Khiladi 786,5600000,385422,-5214578,-93.11746429,2012
7/16/2010,Standing Ovation,5600000,531806,-5068194,-90.50346429,2010
9/27/2013,Don Jon,5500000,24477704,18977704,345.0491636,2013
4/1/2011,Haevnen,5500000,1008098,-4491902,-81.67094545,2011
9/28/2018,Hell Fest,5500000,11107431,5607431,101.9532909,2018
10/21/2011,Le Havre,5500000,611709,-4888291,-88.87801818,2011
5/5/2015,Miss Julie,5500000,0,-5500000,-100,2015
1/23/2015,R100,5500000,24956,-5475044,-99.54625455,2015
7/15/2011,Salvation Boulevard,5500000,28468,-5471532,-99.4824,2011
2/26/2013,Tao Jie,5400000,0,-5400000,-100,2013
7/19/2013,Grabbers,5300000,0,-5300000,-100,2013
4/27/2012,Hodejegerne,5250000,1200010,-4049990,-77.14266667,2012
10/11/2013,La Vie d'AdÃ¨le â Chapitres 1 & 2,5250000,2450504,-2799496,-53.32373333,2013
2/24/2017,The Girl with all the Gifts,5250000,0,-5250000,-100,2017
4/22/2011,Dum Maaro Dum,5200000,564489,-4635511,-89.14444231,2011
3/11/2016,10 Cloverfield Lane,5000000,72082999,67082999,1341.65998,2016
9/11/2015,90 Minutes in Heaven,5000000,4816142,-183858,-3.67716,2015
10/10/2014,Addicted,5000000,17390770,12390770,247.8154,2014
8/16/2013,Ain't Them Bodies Saints,5000000,391611,-4608389,-92.16778,2013
9/2/2011,Apollo 18,5000000,17686929,12686929,253.73858,2011
5/15/2015,Area 51,5000000,7556,-4992444,-99.84888,2015
8/29/2014,"As Above, So Below",5000000,21222315,16222315,324.4463,2014
9/12/2014,Atlas Shrugged: Who Is John Galt?,5000000,851690,-4148310,-82.9662,2014
12/31/2015,Aztec Warrior,5000000,0,-5000000,-100,2015
3/3/2017,Before I Fall,5000000,12241072,7241072,144.82144,2017
1/27/2015,Born of War,5000000,0,-5000000,-100,2015
1/13/2015,Capricorn One,5000000,0,-5000000,-100,2015
8/7/2015,Cop Car,5000000,134552,-4865448,-97.30896,2015
11/1/2013,Dallas Buyers Club,5000000,27298285,22298285,445.9657,2013
2/25/2011,Des Hommes et Des Dieux,5000000,3954651,-1045349,-20.90698,2011
12/5/2014,Dying of the Light,5000000,0,-5000000,-100,2014
5/13/2011,Everything Must Go,5000000,2712131,-2287869,-45.75738,2011
9/21/2018,Fahrenheit 11/9,5000000,6352306,1352306,27.04612,2018
1/29/2016,Fifty Shades of Black,5000000,11686940,6686940,133.7388,2016
2/24/2017,Get Out,5000000,176040665,171040665,3420.8133,2017
4/1/2016,God's Not Dead 2,5000000,20773069,15773069,315.46138,2016
4/15/2016,Green Room,5000000,3220371,-1779629,-35.59258,2016
10/13/2017,Happy Death Day,5000000,55683845,50683845,1013.6769,2017
8/18/2014,Henry & Me,5000000,0,-5000000,-100,2014
7/15/2016,Hillaryâs America: The Secret History of the Democratic Party,5000000,13099931,8099931,161.99862,2016
12/2/2016,Incarnate,5000000,4799774,-200226,-4.00452,2016
9/13/2013,Insidious Chapter 2,5000000,83586447,78586447,1571.72894,2013
6/9/2017,It Comes at Night,5000000,13985117,8985117,179.70234,2017
10/23/2015,Jem and the Holograms,5000000,2184640,-2815360,-56.3072,2015
9/26/2014,Jimi: All is By My Side,5000000,340911,-4659089,-93.18178,2014
10/10/2014,Kill the Messenger,5000000,2450846,-2549154,-50.98308,2014
1/9/2015,Let's Kill Ward's Wife,5000000,0,-5000000,-100,2015
7/22/2016,Lights Out,5000000,67268835,62268835,1245.3767,2016
9/10/2010,"Lovely, Still",5000000,127564,-4872436,-97.44872,2010
5/31/2019,MA,5000000,36049540,31049540,620.9908,2019
10/26/2012,Mientras duermes,5000000,0,-5000000,-100,2012
5/9/2014,Momsâ Night Out,5000000,10429707,5429707,108.59414,2014
9/25/2015,Navy SEAL vs. Zombies,5000000,0,-5000000,-100,2015
8/26/2015,No Escape,5000000,27288872,22288872,445.77744,2015
8/30/2013,No se Aceptan Devoluciones,5000000,44467206,39467206,789.34412,2013
4/11/2014,Oculus,5000000,27695246,22695246,453.90492,2014
10/24/2014,Ouija,5000000,50856010,45856010,917.1202,2014
8/26/2011,Our Idiot Brother,5000000,24814830,19814830,396.2966,2011
10/21/2011,Paranormal Activity 3,5000000,104028807,99028807,1980.57614,2011
10/19/2012,Paranormal Activity 4,5000000,53900335,48900335,978.0067,2012
1/3/2014,Paranormal Activity: The Marked Ones,5000000,32462372,27462372,549.24744,2014
12/28/2016,Paterson,5000000,2141423,-2858577,-57.17154,2016
3/23/2018,"Paul, Apostle of Christ",5000000,17547999,12547999,250.95998,2018
12/31/2010,Psych 9,5000000,0,-5000000,-100,2010
12/17/2010,Rabbit Hole,5000000,2229058,-2770942,-55.41884,2010
2/19/2016,Race,5000000,19115191,14115191,282.30382,2016
11/21/2014,Reach Me,5000000,0,-5000000,-100,2014
10/17/2014,Rudderless,5000000,56001,-4943999,-98.87998,2014
10/27/2015,Running Forever,5000000,0,-5000000,-100,2015
5/28/2010,Sea Rex 3D: Journey to a Prehistoric World,5000000,6096582,1096582,21.93164,2010
12/31/2012,Should've Been Romeo,5000000,0,-5000000,-100,2012
1/20/2017,Split,5000000,138141585,133141585,2662.8317,2017
3/15/2013,Spring Breakers,5000000,14124286,9124286,182.48572,2013
1/16/2015,Still Alice,5000000,18656400,13656400,273.128,2015
3/3/2017,Table 19,5000000,3614896,-1385104,-27.70208,2017
3/17/2017,The Belko Experiment,5000000,10166820,5166820,103.3364,2017
6/23/2017,The Big Sick,5000000,42872467,37872467,757.44934,2017
8/7/2015,The Gift,5000000,43787265,38787265,775.7453,2015
3/15/2016,The Hatching,5000000,0,-5000000,-100,2016
2/27/2015,The Lazarus Effect,5000000,25801570,20801570,416.0314,2015
3/4/2016,The Other Side of the Door,5000000,3000342,-1999658,-39.99316,2016
3/11/2016,The Perfect Match,5000000,9669521,4669521,93.39042,2016
3/9/2018,The Strangers: Prey at Night,5000000,24431472,19431472,388.62944,2018
9/11/2015,The Visit,5000000,65206105,60206105,1204.1221,2015
7/5/2013,The Way Way Back,5000000,21502690,16502690,330.0538,2013
3/9/2018,Thoroughbreds,5000000,3072605,-1927395,-38.5479,2018
9/30/2011,Tucker & Dale vs. Evil,5000000,223838,-4776162,-95.52324,2011
12/31/2011,We Have Your Husband,5000000,0,-5000000,-100,2011
9/2/2016,Yoga Hosers,5000000,0,-5000000,-100,2016
1/23/2015,Mommy,4900000,3498695,-1401305,-28.59806122,2015
8/20/2010,Soul Kitchen,4900000,276901,-4623099,-94.34895918,2010
8/17/2012,The Awakening,4900000,95933,-4804067,-98.04218367,2012
7/19/2013,Only God Forgives,4800000,775849,-4024151,-83.83647917,2013
9/30/2011,Take Shelter,4750000,1728953,-3021047,-63.60098947,2011
3/10/2015,Treading Water,4700000,0,-4700000,-100,2015
12/31/2011,Without Men,4700000,0,-4700000,-100,2011
9/14/2012,Barfi,4600000,2804874,-1795126,-39.02447826,2012
6/24/2011,Le nom des gens,4600000,514237,-4085763,-88.82093478,2011
4/9/2010,After.Life,4500000,108596,-4391404,-97.58675556,2010
10/7/2011,Blackthorn,4500000,200558,-4299442,-95.54315556,2011
12/1/2017,Daisy Winters,4500000,0,-4500000,-100,2017
9/4/2014,Falcon Rising,4500000,11774,-4488226,-99.73835556,2014
11/7/2014,Fugly,4500000,0,-4500000,-100,2014
6/25/2013,Hansel & Gretel Get Baked,4500000,0,-4500000,-100,2013
7/23/2010,Life During Wartime,4500000,281447,-4218553,-93.74562222,2010
5/8/2015,Maggie,4500000,187112,-4312888,-95.84195556,2015
8/19/2011,Nannerl la soeur de Mozart,4500000,707885,-3792115,-84.26922222,2011
9/2/2011,Salvando al Soldado Perez,4500000,1400726,-3099274,-68.87275556,2011
7/23/2010,Spoken Word,4500000,32961,-4467039,-99.26753333,2010
11/3/2015,The Final Girls,4500000,0,-4500000,-100,2015
3/25/2016,The Lobster,4500000,9196278,4696278,104.3617333,2016
3/1/2013,The Sweeney,4500000,26345,-4473655,-99.41455556,2013
8/28/2015,Zipper,4500000,0,-4500000,-100,2015
12/31/2016,Airlift (2016),4400000,0,-4400000,-100,2016
9/29/2015,R.L. Stine's Monsterville: The Cabinet of Souls,4400000,0,-4400000,-100,2015
6/6/2014,Anna,4357373,0,-4357373,-100,2014
7/11/2012,Snabba Cash,4300000,188870,-4111130,-95.60767442,2012
8/13/2010,Animal Kingdom,4200000,1044039,-3155961,-75.14192857,2010
10/21/2011,Cargo,4200000,0,-4200000,-100,2011
5/28/2010,George A. Romero's Survival of the Dead,4200000,101740,-4098260,-97.57761905,2010
4/18/2014,13 Sins,4000000,9134,-3990866,-99.77165,2014
4/18/2014,A Haunted House 2,4000000,17329487,13329487,333.237175,2014
3/20/2012,A Lonely Place to Die,4000000,0,-4000000,-100,2012
11/18/2011,Another Happy Day,4000000,9120,-3990880,-99.772,2011
7/11/2014,Boyhood,4000000,25379975,21379975,534.499375,2014
9/8/2015,Chain of Command,4000000,0,-4000000,-100,2015
4/10/2015,Desert Dancer,4000000,155271,-3844729,-96.118225,2015
12/31/2013,Geograf globus propil,4000000,0,-4000000,-100,2013
1/30/2015,"Guten Tag, Ramon",4000000,154356,-3845644,-96.1411,2015
10/17/2012,Holy Motors,4000000,641054,-3358946,-83.97365,2012
12/31/2012,How to Fall in Love,4000000,0,-4000000,-100,2012
2/22/2013,Inescapable,4000000,4327,-3995673,-99.891825,2013
4/11/2014,Joe,4000000,373375,-3626625,-90.665625,2014
6/7/2019,Late Night,4000000,246305,-3753695,-93.842375,2019
6/19/2015,Manglehorn,4000000,132270,-3867730,-96.69325,2015
12/31/2017,Perfectos Desconocidos,4000000,0,-4000000,-100,2017
8/25/2017,Polina danser sa vie,4000000,165203,-3834797,-95.869925,2017
2/27/2015,Praia do Futuro,4000000,20620,-3979380,-99.4845,2015
9/23/2011,Red State,4000000,1065429,-2934571,-73.364275,2011
11/9/2012,Replicas,4000000,0,-4000000,-100,2012
8/24/2012,Samsara,4000000,2672413,-1327587,-33.189675,2012
4/22/2011,Stake Land,4000000,33245,-3966755,-99.168875,2011
4/2/2010,Tau ming chong,4000000,129078,-3870922,-96.77305,2010
6/17/2011,The Art of Getting By,4000000,1430241,-2569759,-64.243975,2011
1/23/2015,The Boy Next Door,4000000,36006065,32006065,800.151625,2015
5/13/2016,The Darkness,4000000,10753574,6753574,168.83935,2016
3/7/2014,The Face of Love,4000000,385069,-3614931,-90.373275,2014
12/31/2012,The Helpers,4000000,0,-4000000,-100,2012
7/9/2010,The Kids Are All Right,4000000,20811365,16811365,420.284125,2010
3/1/2013,The Last Exorcism Part II,4000000,15179303,11179303,279.482575,2013
6/1/2012,The Loved Ones,4000000,0,-4000000,-100,2012
7/11/2014,The Perfect Wave,4000000,0,-4000000,-100,2014
6/13/2014,The Signal,4000000,600896,-3399104,-84.9776,2014
12/31/2015,The Veil,4000000,0,-4000000,-100,2015
4/1/2011,Trust,4000000,120016,-3879984,-96.9996,2011
1/14/2011,Down for Life,3800000,41914,-3758086,-98.897,2011
10/5/2018,Hevi reissu,3800000,10153,-3789847,-99.73281579,2018
4/30/2010,The Good Heart,3800000,20930,-3779070,-99.44921053,2010
2/19/2010,Defendor,3750000,44462,-3705538,-98.81434667,2010
11/5/2010,Four Lions,3750000,310007,-3439993,-91.73314667,2010
12/31/2017,UtÃ¸ya 22. juli,3600000,0,-3600000,-100,2017
6/28/2011,2:13,3500000,0,-3500000,-100,2011
9/30/2016,American Honey,3500000,663247,-2836753,-81.05008571,2016
1/29/2013,"Batman: The Dark Knight Returns, Part 2",3500000,0,-3500000,-100,2013
12/2/2016,Believe,3500000,890303,-2609697,-74.56277143,2016
2/22/2013,Dark Skies,3500000,17418667,13918667,397.6762,2013
6/5/2015,Dawn Patrol,3500000,0,-3500000,-100,2015
4/16/2010,El secreto de sus ojos,3500000,6391436,2891436,82.61245714,2010
5/18/2018,First Reformed,3500000,3448256,-51744,-1.4784,2018
1/19/2018,Forever My Girl,3500000,16376066,12876066,367.8876,2018
3/11/2014,In the Name of the King III,3500000,0,-3500000,-100,2014
3/18/2016,The Bronze,3500000,615816,-2884184,-82.40525714,2016
12/31/2011,The Kick,3500000,0,-3500000,-100,2011
1/8/2016,The Masked Saint,3500000,182695,-3317305,-94.78014286,2016
2/19/2016,The Witch,3500000,25138705,21638705,618.2487143,2016
6/3/2016,Time to Choose,3500000,29233,-3470767,-99.16477143,2016
6/10/2011,Trolljegeren,3500000,253444,-3246556,-92.75874286,2011
4/13/2018,Truth or Dare,3500000,41411015,37911015,1083.171857,2018
3/4/2014,Wicked Blood,3500000,0,-3500000,-100,2014
2/2/2018,Winchester,3500000,25091816,21591816,616.9090286,2018
5/17/2013,Jagten,3450000,687185,-2762815,-80.0815942,2013
9/1/2015,Lords of London,3440000,0,-3440000,-100,2015
10/21/2011,Margin Call,3400000,5353586,1953586,57.45841176,2011
3/3/2015,To Write Love On Her Arms,3400000,0,-3400000,-100,2015
1/20/2015,The Opposite Sex,3300000,0,-3300000,-100,2015
10/10/2014,Whiplash,3300000,13092006,9792006,296.7274545,2014
6/3/2011,Beginners,3200000,5790894,2590894,80.9654375,2011
7/6/2018,Sorry to Bother You,3200000,17493096,14293096,446.65925,2018
4/22/2016,The Meddler,3200000,4267219,1067219,33.35059375,2016
4/12/2013,Antiviral,3100000,0,-3100000,-100,2013
1/15/2013,30 Nights Of Paranormal Activity With The Devil Inside The Girl With The Dragon Tattoo,3000000,0,-3000000,-100,2013
8/14/2015,Amnesiac,3000000,0,-3000000,-100,2015
12/31/2015,AWOL-72,3000000,0,-3000000,-100,2015
9/7/2012,Bachelorette,3000000,446770,-2553230,-85.10766667,2012
10/1/2010,Barry Munday,3000000,0,-3000000,-100,2010
5/24/2013,Before Midnight,3000000,8110621,5110621,170.3540333,2013
9/4/2015,Before We Go,3000000,37151,-2962849,-98.76163333,2015
10/1/2010,Chain Letter,3000000,205842,-2794158,-93.1386,2010
12/11/2015,Close Range,3000000,0,-3000000,-100,2015
4/22/2016,Compadres,3000000,3127773,127773,4.2591,2016
9/9/2011,Creature,3000000,331000,-2669000,-88.96666667,2011
4/6/2012,Damsels in Distress,3000000,1007535,-1992465,-66.4155,2012
10/10/2017,Demonic,3000000,0,-3000000,-100,2017
7/22/2016,Don't Think Twice,3000000,4417983,1417983,47.2661,2016
2/6/2015,Enter the Dangerous Mind,3000000,0,-3000000,-100,2015
1/15/2010,Fish Tank,3000000,374675,-2625325,-87.51083333,2010
8/15/2014,Fort McCoy,3000000,78948,-2921052,-97.3684,2014
5/17/2013,Frances Ha,3000000,4067398,1067398,35.57993333,2013
5/6/2011,Hobo with a Shotgun,3000000,703372,-2296628,-76.55426667,2011
10/27/2014,Iguana,3000000,0,-3000000,-100,2014
10/27/2017,Let There Be Light,3000000,7233471,4233471,141.1157,2017
4/9/2010,Letters to God,3000000,2848587,-151413,-5.0471,2010
9/13/2011,Never Back Down 2: The Beatdown,3000000,0,-3000000,-100,2011
5/21/2013,Open Road,3000000,0,-3000000,-100,2013
10/20/2010,Paranormal Activity 2,3000000,84752907,81752907,2725.0969,2010
4/30/2010,Please Give,3000000,4033574,1033574,34.45246667,2010
10/12/2012,Sinister,3000000,48086903,45086903,1502.896767,2012
3/17/2015,Something Wicked,3000000,0,-3000000,-100,2015
6/24/2016,Swiss Army Man,3000000,4210454,1210454,40.34846667,2016
9/9/2011,Tanner Hall,3000000,5073,-2994927,-99.8309,2011
12/9/2016,The Bounce Back,3000000,321910,-2678090,-89.26966667,2016
5/8/2015,The D Train,3000000,669688,-2330312,-77.67706667,2015
1/13/2012,The Divide,3000000,18000,-2982000,-99.4,2012
3/26/2010,The Eclipse,3000000,133411,-2866589,-95.55296667,2010
6/7/2013,The Purge,3000000,64473115,61473115,2049.103833,2013
5/12/2017,The Wall,3000000,1803064,-1196936,-39.89786667,2017
6/27/2014,They Came Together,3000000,0,-3000000,-100,2014
3/2/2012,Tim and Eric's Billion Dollar Movie,3000000,201436,-2798564,-93.28546667,2012
9/19/2014,Tusk,3000000,1821983,-1178017,-39.26723333,2014
12/31/2015,Unnatural,3000000,0,-3000000,-100,2015
6/1/2018,Upgrade,3000000,11977130,8977130,299.2376667,2018
8/28/2015,War Room,3000000,67790117,64790117,2159.670567,2015
10/1/2010,Freakonomics,2900000,101270,-2798730,-96.50793103,2010
8/19/2011,Griff the Invisible,2900000,20778,-2879222,-99.28351724,2011
10/26/2018,Indivisible,2700000,3511417,811417,30.05248148,2018
12/31/2015,Sardaar Ji,2700000,0,-2700000,-100,2015
4/1/2011,"Fat, Sick & Nearly Dead",2600000,0,-2600000,-100,2011
5/2/2014,Ida,2600000,3827060,1227060,47.19461538,2014
12/31/2011,La Cara Oculta,2600000,0,-2600000,-100,2011
7/13/2012,2016: Obama's America,2500000,33349941,30849941,1233.99764,2012
10/13/2015,8 Days,2500000,0,-2500000,-100,2015
6/18/2010,8: The Mormon Proposition,2500000,100280,-2399720,-95.9888,2010
1/11/2013,A Haunted House,2500000,40041683,37541683,1501.66732,2013
6/21/2013,Alien Uprising,2500000,0,-2500000,-100,2013
9/2/2016,Antibirth,2500000,0,-2500000,-100,2016
12/31/2010,Christmas Mail,2500000,0,-2500000,-100,2010
6/24/2016,Hunt for the Wilderpeople,2500000,5205471,2705471,108.21884,2016
7/3/2013,Kevin Hart: Let Me Explain,2500000,32244051,29744051,1189.76204,2013
12/31/2014,Not Safe For Work,2500000,0,-2500000,-100,2014
8/17/2012,Robot & Frank,2500000,3317468,817468,32.69872,2012
9/1/2017,Sky Sharks,2500000,0,-2500000,-100,2017
7/3/2015,Stung,2500000,0,-2500000,-100,2015
4/1/2011,Super,2500000,327716,-2172284,-86.89136,2011
3/1/2013,The Lost Medallion: The Adventures of Billy Stone,2500000,549632,-1950368,-78.01472,2013
2/2/2016,The Rise of the Krays,2500000,0,-2500000,-100,2016
8/2/2013,The Spectacular Now,2500000,6852971,4352971,174.11884,2013
8/16/2013,Underdogs,2500000,35017,-2464983,-98.59932,2013
4/9/2010,Valley of the Hearts Delight,2500000,118666,-2381334,-95.25336,2010
5/13/2011,Go For It!,2450000,180237,-2269763,-92.64338776,2011
11/14/2014,Always Woodstock,2400000,0,-2400000,-100,2014
3/20/2015,Do You Believe?,2300000,12985600,10685600,464.5913043,2015
1/19/2016,Eden,2300000,0,-2300000,-100,2016
9/5/2014,Frontera,2300000,59696,-2240304,-97.40452174,2014
8/26/2011,Redemption Road,2300000,29384,-2270616,-98.72243478,2011
4/15/2015,The Toxic Avenger Part II,2300000,0,-2300000,-100,2015
12/31/2012,Infected,2100000,0,-2100000,-100,2012
12/31/2010,Lies in Plain Sight,2100000,0,-2100000,-100,2010
10/16/2016,Mi America,2100000,3330,-2096670,-99.84142857,2016
1/19/2016,Sharkskin,2100000,0,-2100000,-100,2016
10/6/2015,The Timber,2100000,0,-2100000,-100,2015
8/25/2017,All Saints,2000000,5802208,3802208,190.1104,2017
10/23/2015,Bone Tomahawk,2000000,0,-2000000,-100,2015
9/18/2015,Captive,2000000,2583301,583301,29.16505,2015
8/27/2010,Circle,2000000,10024,-1989976,-99.4988,2010
7/9/2013,Coffee Town,2000000,0,-2000000,-100,2013
9/30/2011,Courageous,2000000,34522221,32522221,1626.11105,2011
7/13/2018,Eighth Grade,2000000,13539710,11539710,576.9855,2018
9/9/2011,Grave Encounters,2000000,0,-2000000,-100,2011
2/3/2017,Growing up Smith,2000000,35312,-1964688,-98.2344,2017
4/8/2016,Hardcore Henry,2000000,9252038,7252038,362.6019,2016
6/8/2018,Hearts Beat Loud,2000000,2386254,386254,19.3127,2018
12/31/2012,Highway,2000000,0,-2000000,-100,2012
10/8/2010,Inside Job,2000000,4311834,2311834,115.5917,2010
3/13/2015,It Follows,2000000,14674077,12674077,633.70385,2015
6/11/2010,Jerusalema,2000000,7294,-1992706,-99.6353,2010
10/9/2015,Knock Knock,2000000,36336,-1963664,-98.1832,2015
4/25/2014,Locke,2000000,1370646,-629354,-31.4677,2014
4/7/2015,Lost River,2000000,45431,-1954569,-97.72845,2015
12/31/2014,Lucky Dog,2000000,0,-2000000,-100,2014
4/8/2011,Meek's Cutoff,2000000,977772,-1022228,-51.1114,2011
10/10/2014,Meet the Mormons,2000000,6047363,4047363,202.36815,2014
9/13/2013,Plush,2000000,3080,-1996920,-99.846,2013
9/19/2014,Pump,2000000,72277,-1927723,-96.38615,2014
1/29/2010,Saint John of Las Vegas,2000000,102645,-1897355,-94.86775,2010
12/1/2015,Shark Lake,2000000,0,-2000000,-100,2015
3/9/2012,Silent House,2000000,12739737,10739737,536.98685,2012
2/8/2013,Small Apartments,2000000,0,-2000000,-100,2013
4/1/2013,Stitches,2000000,0,-2000000,-100,2013
3/19/2013,Straight A's,2000000,0,-2000000,-100,2013
11/28/2014,The Babadook,2000000,950792,-1049208,-52.4604,2014
8/21/2015,The Curse of Downers Grove,2000000,0,-2000000,-100,2015
8/7/2015,The Diary of a Teenage Girl,2000000,1477002,-522998,-26.1499,2015
7/8/2016,The Dog Lover,2000000,0,-2000000,-100,2016
10/19/2012,The First Time,2000000,17061,-1982939,-99.14695,2012
10/6/2017,The Florida Project,2000000,5904366,3904366,195.2183,2017
10/26/2012,The Ghastly Love of Johnny X,2000000,2436,-1997564,-99.8782,2012
3/17/2015,The Lady from Shanghai,2000000,0,-2000000,-100,2015
2/13/2015,The Last Five Years,2000000,147299,-1852701,-92.63505,2015
3/30/2012,The Legend of Hellâs Gate: An American Conspiracy,2000000,0,-2000000,-100,2012
1/20/2017,The Resurrection of Gavin Stone,2000000,2303792,303792,15.1896,2017
9/24/2010,The Virginity Hit,2000000,636706,-1363294,-68.1647,2010
3/20/2015,The Walking Deceased,2000000,0,-2000000,-100,2015
12/31/2015,"To Be Frank, Sinatra at 100",2000000,0,-2000000,-100,2015
12/31/2011,True Bromance,2000000,0,-2000000,-100,2011
8/28/2015,We Are Your Friends,2000000,3591417,1591417,79.57085,2015
12/31/2015,Wind Walkers,2000000,0,-2000000,-100,2015
6/11/2010,Winter's Bone,2000000,6531503,4531503,226.57515,2010
9/24/2010,Buried,1987650,1044143,-943507,-47.46846779,2010
4/21/2015,The Marine 4,1950000,0,-1950000,-100,2015
2/8/2013,ABCD (Any Body Can Dance),1900000,222098,-1677902,-88.31063158,2013
4/24/2015,Brotherly Love,1900000,478595,-1421405,-74.81078947,2015
10/8/2010,Nowhere Boy,1900000,1445366,-454634,-23.92810526,2010
7/26/2013,Stranded,1900000,0,-1900000,-100,2013
6/3/2011,Submarine,1900000,467602,-1432398,-75.38936842,2011
4/9/2010,The Square,1900000,406216,-1493784,-78.62021053,2010
12/31/2015,Vaalu,1900000,0,-1900000,-100,2015
3/11/2014,Against the Wild,1800000,0,-1800000,-100,2014
6/27/2012,Beasts of the Southern Wild,1800000,12795746,10995746,610.8747778,2012
10/20/2015,Beginnerâs Guide to Sex,1800000,0,-1800000,-100,2015
2/3/2012,Dysfunctional Friends,1800000,0,-1800000,-100,2012
8/23/2011,Higher Ground,1800000,841056,-958944,-53.27466667,2011
12/31/2013,Independence Daysaster,1800000,0,-1800000,-100,2013
4/22/2011,POM Wonderful Presents: The Greatest Movie Ever Sold,1800000,638476,-1161524,-64.52911111,2011
8/27/2010,The Last Exorcism,1800000,41034350,39234350,2179.686111,2010
10/8/2010,I Spit on Your Grave,1750000,93051,-1656949,-94.6828,2010
4/23/2019,Living Dark: The Story of Ted the Caver,1750000,0,-1750000,-100,2019
10/4/2013,Grace Unplugged,1700000,2507159,807159,47.47994118,2013
12/18/2015,Saul fia,1700000,1777043,77043,4.531941176,2015
2/28/2014,The Lunchbox,1700000,4231500,2531500,148.9117647,2014
2/1/2019,Braid,1660000,0,-1660000,-100,2019
10/15/2010,N-Secure,1600000,2595644,995644,62.22775,2010
9/26/2014,Two Night Stand,1600000,15600,-1584400,-99.025,2014
10/21/2016,31,1500000,779820,-720180,-48.012,2016
11/20/2015,#Horror,1500000,0,-1500000,-100,2015
8/19/2011,Amigo,1500000,184705,-1315295,-87.68633333,2011
9/8/2015,Checkmate,1500000,0,-1500000,-100,2015
4/17/2014,Closer to the Moon,1500000,0,-1500000,-100,2014
2/13/2015,Girlhouse,1500000,0,-1500000,-100,2015
10/17/2014,Housebound,1500000,0,-1500000,-100,2014
10/21/2016,Iâm Not Ashamed,1500000,2082980,582980,38.86533333,2016
4/1/2011,Insidious,1500000,54009150,52509150,3500.61,2011
9/28/2015,"Me, You and Five Bucks",1500000,2105,-1497895,-99.85966667,2015
10/21/2016,Moonlight,1500000,27854931,26354931,1756.9954,2016
2/11/2011,MOOZ-lum,1500000,362239,-1137761,-75.85073333,2011
5/26/2015,Mutant World,1500000,0,-1500000,-100,2015
11/11/2014,Once Upon a Time in Queens,1500000,0,-1500000,-100,2014
3/6/2015,Road Hard,1500000,113169,-1386831,-92.4554,2015
7/20/2018,Teefa in Trouble,1500000,0,-1500000,-100,2018
8/6/2010,The Disappearance of Alice Creed,1500000,166980,-1333020,-88.868,2010
2/1/2013,The Gatekeepers,1500000,2408553,908553,60.5702,2013
6/3/2011,The Lion of Judah,1500000,0,-1500000,-100,2011
4/19/2013,The Lords of Salem,1500000,1165881,-334119,-22.2746,2013
10/25/2013,The Square,1500000,124244,-1375756,-91.71706667,2013
7/26/2013,The To Do List,1500000,3491669,1991669,132.7779333,2013
3/23/2018,Unsane,1500000,7690044,6190044,412.6696,2018
4/22/2016,Unsullied,1500000,510957,-989043,-65.9362,2016
4/5/2013,Eddie: The Sleepwalking Cannibal,1400000,1632,-1398368,-99.88342857,2013
12/31/2014,House at the End of the Drive,1400000,0,-1400000,-100,2014
12/31/2014,Kurmanjan datka,1400000,0,-1400000,-100,2014
10/3/2014,La chambre bleue,1400000,260441,-1139559,-81.39707143,2014
11/20/2015,Mustang,1400000,845464,-554536,-39.60971429,2015
5/1/2010,My Girlfriend's Boyfriend,1400000,0,-1400000,-100,2010
11/30/2018,Werk ohne Autor,1400000,1303747,-96253,-6.875214286,2018
1/30/2015,Above and Beyond,1300000,288751,-1011249,-77.78838462,2015
5/24/2011,Forget Me Not,1300000,0,-1300000,-100,2011
6/13/2014,Los insolitos peces gato,1300000,11278,-1288722,-99.13246154,2014
6/8/2010,The 41-Year-Old Virgin Who Knocked Up Sarah Marshall and Felt Superbad About It,1300000,0,-1300000,-100,2010
6/26/2015,The Algerian,1300000,0,-1300000,-100,2015
12/31/2016,Bodom,1250000,0,-1250000,-100,2016
1/13/2015,Da Sweet Blood of Jesus,1250000,0,-1250000,-100,2015
10/17/2014,Dear White People,1250000,4404154,3154154,252.33232,2014
4/19/2013,Filly Brown,1250000,2850357,1600357,128.02856,2013
9/14/2012,Airborne,1200000,0,-1200000,-100,2012
8/28/2012,Below Zero,1200000,0,-1200000,-100,2012
2/3/2015,Bleeding Hearts,1200000,0,-1200000,-100,2015
2/6/2018,Blood Feast,1200000,8708,-1191292,-99.27433333,2018
4/13/2012,Blue Like Jazz,1200000,595018,-604982,-50.41516667,2012
2/11/2011,Certifiably Jonathan,1200000,7826,-1192174,-99.34783333,2011
9/9/2014,Cotton Comes to Harlem,1200000,0,-1200000,-100,2014
9/7/2012,Crowsnest,1200000,0,-1200000,-100,2012
4/19/2013,Home Run,1200000,2859955,1659955,138.3295833,2013
9/18/2015,La navaja de Don Juan,1200000,4254,-1195746,-99.6455,2015
6/1/2012,"Pink Ribbons, Inc.",1200000,26608,-1173392,-97.78266667,2012
8/28/2015,Que Horas Ela Volta?,1200000,376976,-823024,-68.58533333,2015
12/31/2017,The Islands,1200000,0,-1200000,-100,2017
12/31/2013,The Wicked Within,1200000,0,-1200000,-100,2013
3/21/2014,God's Not Dead,1150000,60755732,59605732,5183.10713,2014
5/18/2012,Beyond the Black Rainbow,1100000,56491,-1043509,-94.86445455,2012
3/7/2017,Departure,1100000,0,-1100000,-100,2017
3/23/2010,Lake Mungo,1100000,0,-1100000,-100,2010
3/23/2012,Serbuan maut,1100000,4105123,3005123,273.193,2012
4/7/2015,Silent Running,1100000,0,-1100000,-100,2015
12/31/2010,The Dead Undead,1100000,0,-1100000,-100,2010
11/21/2014,The Sleepwalker,1100000,2636,-1097364,-99.76036364,2014
12/31/2013,The Vatican Exorcisms,1100000,0,-1100000,-100,2013
3/1/2016,1982,1000000,0,-1000000,-100,2016
9/3/2010,16 to Life,1000000,11574,-988426,-98.8426,2010
6/14/2013,20 Feet From Stardom,1000000,4946250,3946250,394.625,2013
10/24/2014,23 Blast,1000000,549185,-450815,-45.0815,2014
6/24/2014,A Fine Step,1000000,0,-1000000,-100,2014
2/3/2010,Ajami,1000000,621859,-378141,-37.8141,2010
12/11/2015,American Hero,1000000,0,-1000000,-100,2015
7/28/2017,An Inconvenient Sequel,1000000,3496795,2496795,249.6795,2017
11/28/2014,Antarctica: A Year on Ice,1000000,288757,-711243,-71.1243,2014
12/31/2014,Bang Bang Baby,1000000,0,-1000000,-100,2014
7/31/2015,Beyond the Brick: A LEGO Brickumentary,1000000,101531,-898469,-89.8469,2015
5/14/2013,Black Rock,1000000,0,-1000000,-100,2013
12/29/2010,Blue Valentine,1000000,9737892,8737892,873.7892,2010
10/17/2014,Camp X-Ray,1000000,9837,-990163,-99.0163,2014
12/31/2016,Chemical Cut,1000000,0,-1000000,-100,2016
5/25/2012,Chernobyl Diaries,1000000,18119640,17119640,1711.964,2012
5/15/2015,Childless,1000000,1036,-998964,-99.8964,2015
3/11/2016,Creative Control,1000000,63014,-936986,-93.6986,2016
12/31/2014,Doc Holliday's Revenge,1000000,0,-1000000,-100,2014
2/10/2015,Fear Clinic,1000000,0,-1000000,-100,2015
6/1/2012,Hardflip,1000000,96734,-903266,-90.3266,2012
12/31/2013,Heli,1000000,0,-1000000,-100,2013
3/11/2016,"Hello, My Name is Doris",1000000,14444999,13444999,1344.4999,2016
1/7/2014,Hidden Away,1000000,0,-1000000,-100,2014
2/13/2015,Hits,1000000,15156,-984844,-98.4844,2015
4/8/2016,Hush,1000000,0,-1000000,-100,2016
2/3/2017,I Am Not Your Negro,1000000,7123919,6123919,612.3919,2017
7/18/2014,I Origins,1000000,336472,-663528,-66.3528,2014
12/31/2015,Karachi se Lahore,1000000,0,-1000000,-100,2015
10/21/2011,Martha Marcy May Marlene,1000000,2981038,1981038,198.1038,2011
10/4/2013,My Last Day Without You,1000000,0,-1000000,-100,2013
6/6/2014,Obvious Child,1000000,3122616,2122616,212.2616,2014
3/23/2012,October Baby,1000000,5355847,4355847,435.5847,2012
5/9/2014,Palo Alto,1000000,767732,-232268,-23.2268,2014
8/18/2017,Patti Cake$,1000000,800148,-199852,-19.9852,2017
12/22/2015,Por amor en el caserio,1000000,0,-1000000,-100,2015
3/20/2012,Snow White: A Deadly Summer,1000000,0,-1000000,-100,2012
7/19/2013,The Act of Killing,1000000,486919,-513081,-51.3081,2013
1/6/2012,The Devil Inside,1000000,53262945,52262945,5226.2945,2012
7/29/2011,The Future,1000000,568662,-431338,-43.1338,2011
9/25/2015,The Green Inferno,1000000,7192291,6192291,619.2291,2015
10/27/2015,The Horror Network,1000000,0,-1000000,-100,2015
4/8/2016,The Invitation,1000000,231738,-768262,-76.8262,2016
7/1/2011,The Perfect Host,1000000,48764,-951236,-95.1236,2011
3/10/2015,The Pet,1000000,0,-1000000,-100,2015
10/19/2012,The Sessions,1000000,6002451,5002451,500.2451,2012
4/10/2015,The Sisterhood of Night,1000000,6870,-993130,-99.313,2015
9/12/2014,The Skeleton Twins,1000000,5284309,4284309,428.4309,2014
10/9/2012,Truth or Die,1000000,0,-1000000,-100,2012
4/17/2015,Unfriended,1000000,32789645,31789645,3178.9645,2015
7/20/2018,Unfriended: Dark Web,1000000,8866745,7866745,786.6745,2018
10/6/2017,Visages villages,1000000,952432,-47568,-4.7568,2017
8/23/2013,You're Next,1000000,18494006,17494006,1749.4006,2013
10/8/2013,Zombie Hunter,1000000,0,-1000000,-100,2013
1/29/2010,Zombies of Mass Destruction,1000000,0,-1000000,-100,2010
3/3/2015,Ask Me Anything,950000,0,-950000,-100,2015
1/10/2014,Banshee Chapter,950000,0,-950000,-100,2014
8/12/2014,Jesse,950000,0,-950000,-100,2014
12/31/2012,Trance,950000,0,-950000,-100,2012
4/13/2012,L!fe Happens,930000,30905,-899095,-96.67688172,2012
5/12/2017,Lowriders,916000,6179955,5263955,574.6675764,2017
11/21/2014,Food Chains,913000,0,-913000,-100,2014
12/31/2014,40 Weeks,900000,0,-900000,-100,2014
8/26/2011,Circumstance,900000,454121,-445879,-49.54211111,2011
7/12/2013,Fruitvale Station,900000,16098998,15198998,1688.777556,2013
5/5/2015,Le bonheur d'Elza,900000,0,-900000,-100,2015
4/1/2016,Meet the Blacks,900000,9097072,8197072,910.7857778,2016
4/5/2013,The Brass Teapot,900000,6997,-893003,-99.22255556,2013
4/27/2012,The Giant Mechanical Man,900000,7396,-892604,-99.17822222,2012
8/31/2012,"For a Good Time, Call",850000,1251749,401749,47.26458824,2012
12/31/2012,Snitch,850000,0,-850000,-100,2012
8/28/2015,Windsor Drive,850000,3256,-846744,-99.61694118,2015
8/3/2012,Celeste and Jesse Forever,840000,3103407,2263407,269.4532143,2012
12/30/2011,Jodaeiye Nader az Simin,800000,7098492,6298492,787.3115,2011
2/3/2012,Kill List,800000,29063,-770937,-96.367125,2012
9/19/2014,Not Cool,800000,35688,-764312,-95.539,2014
1/9/2015,Vessel,800000,0,-800000,-100,2015
1/5/2016,Adulterers,750000,0,-750000,-100,2016
10/11/2013,All the Boys Love Mandy Lane,750000,0,-750000,-100,2013
12/31/2014,Destiny,750000,0,-750000,-100,2014
8/29/2014,Il conformista,750000,59656,-690344,-92.04586667,2014
9/9/2011,Kevin Hart: Laugh at My Pain,750000,7706436,6956436,927.5248,2011
6/8/2012,Safety Not Guaranteed,750000,4010957,3260957,434.7942667,2012
2/3/2012,The Innkeepers,750000,78396,-671604,-89.5472,2012
1/26/2010,B-Girl,700000,0,-700000,-100,2010
8/4/2017,Columbus,700000,1017107,317107,45.301,2017
3/13/2015,Walter,700000,0,-700000,-100,2015
12/31/2012,After,650000,0,-650000,-100,2012
10/11/2013,Escape from Tomorrow,650000,171962,-478038,-73.54430769,2013
12/14/2018,That Way Madness Lies,650000,1447,-648553,-99.77738462,2018
12/31/2014,The Hadza: Last of the First,650000,0,-650000,-100,2014
12/31/2013,Treachery,625000,0,-625000,-100,2013
5/22/2015,Drunk Wedding,600000,3301,-596699,-99.44983333,2015
2/24/2015,Irreplaceable,600000,0,-600000,-100,2015
12/31/2014,Light from the Darkroom,600000,0,-600000,-100,2014
8/8/2014,The Maid's Room,600000,0,-600000,-100,2014
3/4/2016,They Will Have to Kill Us First,600000,0,-600000,-100,2016
5/2/2014,Water & Power,600000,42557,-557443,-92.90716667,2014
12/31/2015,Julija in alfa Romeo,560000,0,-560000,-100,2015
7/29/2011,The Harvest/La Cosecha,560000,3709,-556291,-99.33767857,2011
9/12/2014,Faith Connections,550000,9111,-540889,-98.34345455,2014
3/6/2012,High Road,546173,0,-546173,-100,2012
8/11/2015,Alleluia! The Devil's Carnival,500000,0,-500000,-100,2015
12/31/2014,America Is Still The Place,500000,0,-500000,-100,2014
9/10/2014,Born to Fly: Elizabeth Streb vs. Gravity,500000,1822,-498178,-99.6356,2014
12/1/2015,Brooklyn Bizarre,500000,0,-500000,-100,2015
12/31/2013,Bucky and the Squirrels,500000,0,-500000,-100,2013
6/23/2015,Crossroads,500000,0,-500000,-100,2015
4/17/2013,Deceptive Practice: The Mysteries and Mentors of Ricky Jay,500000,152449,-347551,-69.5102,2013
6/28/2013,Detention of the Dead,500000,1778,-498222,-99.6444,2013
12/31/2014,Diamond Ruff,500000,0,-500000,-100,2014
8/23/2013,Drinking Buddies,500000,343706,-156294,-31.2588,2013
12/31/2010,Drones,500000,0,-500000,-100,2010
12/31/2012,El rey de Najayo,500000,0,-500000,-100,2012
4/3/2012,Enter Nowhere,500000,0,-500000,-100,2012
12/31/2015,Fight to the Finish,500000,0,-500000,-100,2015
7/17/2012,Girls Gone Dead,500000,0,-500000,-100,2012
5/11/2018,Higher Power,500000,528,-499472,-99.8944,2018
2/10/2015,Love in the Time of Monsters,500000,0,-500000,-100,2015
10/29/2010,Monsters,500000,237301,-262699,-52.5398,2010
1/8/2013,Now is Good,500000,0,-500000,-100,2013
12/11/2015,O Menino e o Mundo,500000,129479,-370521,-74.1042,2015
4/14/2015,Roadside,500000,0,-500000,-100,2015
12/31/2015,Rodeo Girl,500000,0,-500000,-100,2015
4/1/2011,Rubber,500000,100370,-399630,-79.926,2011
7/8/2011,Sholem Aleichem: Laughing in the Darkness,500000,1131261,631261,126.2522,2011
3/10/2015,Subconscious,500000,0,-500000,-100,2015
11/10/2015,The Little Ponderosa Zoo,500000,0,-500000,-100,2015
5/14/2010,The Living Wake,500000,12232,-487768,-97.5536,2010
9/28/2012,The Other Dream Team,500000,134109,-365891,-73.1782,2012
7/24/2015,The Outrageous Sophie Tucker,500000,0,-500000,-100,2015
12/31/2014,The Sound and the Shadow,500000,0,-500000,-100,2014
1/22/2010,To Save a Life,500000,3777210,3277210,655.442,2010
7/11/2014,As It Is in Heaven,450000,13486,-436514,-97.00311111,2014
7/1/2014,Mutual Friends,450000,0,-450000,-100,2014
12/31/2014,Rise Of the Entrepreneur - The Search For A Better Way,450000,0,-450000,-100,2014
11/20/2015,Siakh lokhamim: ha'slilim ha'gnouzim,450000,41260,-408740,-90.83111111,2015
4/25/2014,Blue Ruin,420000,258384,-161616,-38.48,2014
10/15/2010,I Want Your Money,400000,433588,33588,8.397,2010
12/31/2014,Pancakes,400000,0,-400000,-100,2014
3/31/2015,Viskningar och rop,400000,0,-400000,-100,2015
9/5/2016,Intolerance,385907,0,-385907,-100,2016
9/1/2010,My Dog Tulip,350000,246574,-103426,-29.55028571,2010
10/20/2015,Rotor DR1,350000,0,-350000,-100,2015
6/25/2010,Kynodontas,323000,110248,-212752,-65.86749226,2010
3/11/2011,3 Backyards,300000,39475,-260525,-86.84166667,2011
10/31/2014,All You Need Is Love,300000,0,-300000,-100,2014
12/8/2015,Amidst the Devil's Wings,300000,0,-300000,-100,2015
12/31/2010,Anderson's Cross,300000,0,-300000,-100,2010
3/28/2014,Locker 13,300000,3496,-296504,-98.83466667,2014
8/7/2013,Midnight Cabaret,300000,0,-300000,-100,2013
11/9/2012,Nothing But a Man,300000,17241,-282759,-94.253,2012
7/3/2012,Some Guy Who Kills People,300000,0,-300000,-100,2012
3/10/2015,Teeth and Blood,300000,0,-300000,-100,2015
10/23/2015,The Looking Glass,300000,1711,-298289,-99.42966667,2015
12/31/2015,Walking to Paris,300000,0,-300000,-100,2015
12/31/2010,Death Calls,290000,0,-290000,-100,2010
8/17/2012,Compliance,270000,319285,49285,18.2537037,2012
1/1/2015,11-Apr,250000,0,-250000,-100,2015
3/24/2015,Along the Roadside,250000,0,-250000,-100,2015
12/31/2010,Butterfly,250000,0,-250000,-100,2010
2/24/2015,Give Me Shelter,250000,0,-250000,-100,2015
12/31/2014,Horse Camp,250000,0,-250000,-100,2014
4/11/2014,Jesus People,250000,0,-250000,-100,2014
10/28/2011,Like Crazy,250000,3395391,3145391,1258.1564,2011
8/15/2014,Nightlights,250000,21147,-228853,-91.5412,2014
12/31/2011,Rock the House,250000,0,-250000,-100,2011
10/5/2010,Rust,250000,0,-250000,-100,2010
12/31/2015,Shooting the Warwicks,250000,0,-250000,-100,2015
4/28/2017,Sleight,250000,3930990,3680990,1472.396,2017
6/6/2014,Test,250000,18823,-231177,-92.4708,2014
8/2/2013,The Canyons,250000,59671,-190329,-76.1316,2013
12/31/2010,The Christmas Bunny,250000,0,-250000,-100,2010
12/18/2012,The Frozen,250000,0,-250000,-100,2012
8/18/2015,The Love Letter,250000,0,-250000,-100,2015
2/3/2015,UnDivided,250000,0,-250000,-100,2015
10/9/2015,Western Religion,250000,0,-250000,-100,2015
7/20/2012,Burn,225000,1109276,884276,393.0115556,2012
12/24/2016,"20,000 Leagues Under the Sea",200000,8000000,7800000,3900,2016
9/12/2014,Archaeology of a Woman,200000,0,-200000,-100,2014
12/31/2014,H.,200000,0,-200000,-100,2014
10/12/2012,Middle of Nowhere,200000,236806,36806,18.403,2012
11/10/2015,Perfect Cowboy,200000,0,-200000,-100,2015
8/26/2014,Sanctuary; Quite a Conundrum,200000,0,-200000,-100,2014
2/25/2011,The Grace Card,200000,2430735,2230735,1115.3675,2011
6/19/2015,The Overnight,200000,1109808,909808,454.904,2015
3/14/2014,The Word,200000,3648,-196352,-98.176,2014
9/29/2015,Theresa Is a Mother,200000,0,-200000,-100,2015
9/23/2011,Weekend,190000,484592,294592,155.0484211,2011
6/16/2017,Arrowhead,180000,0,-180000,-100,2017
2/27/2015,Butterfly Girl,180000,17503,-162497,-90.27611111,2015
7/22/2011,Another Earth,175000,1321194,1146194,654.968,2011
9/4/2015,Heroes of Dirt,175000,0,-175000,-100,2015
8/23/2013,Sparrows Dance,175000,2602,-172398,-98.51314286,2013
6/3/2016,The Fits,170000,166425,-3575,-2.102941176,2016
12/31/2015,Lumea e a mea,168000,0,-168000,-100,2015
4/17/2015,Antarctic Edge: 70Âº South,150000,7193,-142807,-95.20466667,2015
5/3/2013,Aroused,150000,0,-150000,-100,2013
12/31/2015,Escaping the Holocost,150000,0,-150000,-100,2015
12/31/2013,Speak No Evil,150000,0,-150000,-100,2013
8/21/2015,Top Spin,150000,5858,-144142,-96.09466667,2015
4/27/2012,Sound of My Voice,135000,408015,273015,202.2333333,2012
7/18/2014,An American in Hollywood,125000,0,-125000,-100,2014
12/31/2015,Romantic Schemer,125000,0,-125000,-100,2015
8/11/2015,The Brain That Sings,125000,0,-125000,-100,2015
5/24/2016,Une Femme MariÃ©e,120000,0,-120000,-100,2016
6/15/2012,Your Sister's Sister,120000,1597486,1477486,1231.238333,2012
2/8/2015,The Birth of a Nation,110000,10000000,9890000,8990.909091,2015
7/7/2017,A Ghost Story,100000,1594798,1494798,1494.798,2017
3/21/2014,Cheap Thrills,100000,59424,-40576,-40.576,2014
3/17/2015,Closure,100000,0,-100000,-100,2015
12/31/2014,"Dude, Where's My Dog",100000,0,-100000,-100,2014
6/10/2014,Echo Dr.,100000,0,-100000,-100,2014
5/18/2012,Indie Game: The Movie,100000,0,-100000,-100,2012
12/31/2015,Lunchtime Heroes,100000,0,-100000,-100,2015
3/25/2015,Open Secret,100000,0,-100000,-100,2015
7/10/2015,The Gallows,100000,22764410,22664410,22664.41,2015
11/10/2015,The Night Visitor,100000,0,-100000,-100,2015
6/19/2014,The Past is a Grotesque Animal,100000,20056,-79944,-79.944,2014
7/7/2015,Tiger Orange,100000,0,-100000,-100,2015
7/17/2015,Dawn of the Crescent Moon,75000,8799,-66201,-88.268,2015
9/29/2015,Queen Crab,75000,0,-75000,-100,2015
12/31/2011,Absentia,70000,0,-70000,-100,2011
7/25/2014,Happy Christmas,70000,30312,-39688,-56.69714286,2014
12/31/2012,Hayride,60000,0,-60000,-100,2012
1/25/2013,Supporting Characters,60000,4917,-55083,-91.805,2013
3/16/2012,The FP,60000,0,-60000,-100,2012
10/4/2013,The Dirties,55000,0,-55000,-100,2013
8/4/2015,Bending Steel,50000,0,-50000,-100,2015
7/31/2015,Counting,50000,8374,-41626,-83.252,2015
2/14/2014,Down and Dangerous,50000,0,-50000,-100,2014
9/1/2015,"Run, Hide, Die",50000,0,-50000,-100,2015
12/31/2014,The Image Revolution,50000,0,-50000,-100,2014
11/12/2010,Tiny Furniture,50000,391674,341674,683.348,2010
10/25/2013,A True Story,45000,0,-45000,-100,2013
6/21/2013,This Is Martin Bonner,42000,0,-42000,-100,2013
3/31/2012,Foreign Letters,40000,0,-40000,-100,2012
2/11/2011,Raymond Did It,40000,3632,-36368,-90.92,2011
3/12/2010,The Exploding Girl,40000,25572,-14428,-36.07,2010
12/31/2014,Happy 40th,35000,0,-35000,-100,2014
10/25/2013,Her Cry: La Llorona Investigation,35000,0,-35000,-100,2013
10/15/2010,Down Terrace,30000,9812,-20188,-67.29333333,2010
3/18/2016,Krisha,30000,144822,114822,382.74,2016
12/31/2013,Paraphobia,30000,0,-30000,-100,2013
1/27/2017,Emily,27000,3547,-23453,-86.86296296,2017
12/1/2015,Dutch Kills,25000,0,-25000,-100,2015
9/1/2015,Exeter,25000,0,-25000,-100,2015
4/21/2015,Ten,25000,0,-25000,-100,2015
12/31/2014,Dry Spell,22000,0,-22000,-100,2014
1/4/2013,All Superheroes Must Die,20000,0,-20000,-100,2013
4/21/2015,The Front Man,20000,0,-20000,-100,2015
11/25/2011,The Ridges,17300,0,-17300,-100,2011
4/2/2010,Breaking Upwards,15000,115592,100592,670.6133333,2010
12/31/2014,Stories of Our Lives,15000,0,-15000,-100,2014
5/19/2015,Family Motocross,10000,0,-10000,-100,2015
1/13/2012,Newlyweds,9000,4584,-4416,-49.06666667,2012
12/31/2018,Red 11,7000,0,-7000,-100,2018
9/29/2015,A Plague So Pleasant,1400,0,-1400,-100,2015
